"a" = (/turf/template_noop,/area/template_noop)
"b" = (/turf/closed/wall/rust,/area/template_noop)
"c" = (/turf/open/floor/carpet,/area/template_noop)
"d" = (/obj/structure/table,/turf/open/floor/wood,/area/template_noop)
"e" = (/turf/open/floor/wood,/area/template_noop)
"f" = (/obj/structure/table,/turf/open/floor/carpet,/area/template_noop)
"g" = (/turf/open/floor/grass,/area/template_noop)
"h" = (/obj/structure/closet/secure/loot,/turf/open/floor/wood,/area/template_noop)
"i" = (/obj/structure/barrel/shit,/turf/open/floor/wood,/area/template_noop)
"j" = (/obj/structure/barrel/shit,/turf/open/floor/carpet,/area/template_noop)
"k" = (/obj/structure/chair{dir = 1},/turf/open/floor/carpet,/area/template_noop)
"l" = (/obj/structure/chair{dir = 8},/turf/open/floor/carpet,/area/template_noop)
"m" = (/obj/structure/closet/crate/bin,/turf/open/floor/wood,/area/template_noop)
"n" = (/obj/structure/chair,/turf/open/floor/wood,/area/template_noop)
"o" = (/obj/structure/closet/crate/secure/weapon,/turf/open/floor/wood,/area/template_noop)
"p" = (/obj/structure/chair{dir = 8},/turf/open/floor/wood,/area/template_noop)
"q" = (/obj/structure/chair{dir = 1},/turf/open/floor/wood,/area/template_noop)
"r" = (/obj/effect/spawner/lootdrop/maintenance,/turf/open/floor/grass,/area/template_noop)
"s" = (/obj/effect/spawner/lootdrop/maintenance,/turf/open/floor/carpet,/area/template_noop)
"t" = (/obj/effect/spawner/lootdrop/maintenance,/turf/open/floor/wood,/area/template_noop)
"u" = (/obj/structure/table,/obj/effect/spawner/lootdrop/maintenance,/turf/open/floor/wood,/area/template_noop)

(1,1,1) = {"
aaaaaaaaaaaaaaaaaaaaaaaaaaaaaaaaaaaaaaaaaaaaaaaaaaaaaaaaa
aaaaaaaaaaaaaaaaaaaaaaaaaaaaaaaaaaaaaaaaaaaaaaaaaaaaaaaaa
aaaaaaaaaaaaaaaaaaaaaaaaaaaaaaaaaaaaaaaaaaaaaaaaaaaaaaaaa
aaaaaaagggggggggggggggggaaaaaaaaaaaaaaaaaaaaaaaaaaaaaaaaa
aaaaaaagggggggggggggggggaaaaaaaaaaaaaaaaaaaaaaaaaaaaaaaaa
aaaaaaagggggggggggggggggaaaaaaaaaaaaaaaaaaaaaaaaaaaaaaaaa
aaaaaaaggggggrggggggggggaaaaaaaaaaaaaaaaaaaaaaaaaaaaaaaaa
aaaaaaaggggggggrrgggggggaaaaaaaaaaaaaaaaaaaaaaaaaaaaaaaaa
aaaaaaaggggrgrrrggggggggaaaaaaaaaaaaaaaaaaaaaaaaaaaaaaaaa
aaaaaaaggrgggrggrgggggggaaaaaaaaaaaaaaaaaaaaaaaaaaaaaaaaa
aaaaaaagggggggggggggggggaaaaaaaaaaaaaaaaaaaaaaaaaaaaaaaaa
aaaaaaagggggggggggrgggggaaaaaaaaaaaaaaaaaaaaaaaaaaaaaaaaa
aaaaaaagggggggggggggggggaaaaaaaaaaaaaaaaaaaaaaaaaaaaaaaaa
aaaaaaagggggggggggggggggaaaaabbbbbbbaaaaaaaaaaaaaaaaaaaaa
aaaaaaaaaaaaaaaaaaaaaaaaaaaaabsccccbaaaaaaaaaaaaaaaaaaaaa
aaaaaaaaaaaaaaaaaaaaaaaaaaaaabcccccbaaaaaaaaaaaaaaaaaaaaa
aaaaaaaaaaaaaaaaaaaaaaaaaaaaabccccsbaaaaaaaaaaaaaaaaaaaaa
aaaaaaaaaaaaaaaaaaaaaaaaaaaaabcccccbaaaaaaaaaaaaaaaaaaaaa
aaaaaaaaaaaaaaaaaaabbbbbbbbbbbbbcbbbbbaaaaaaaaaaaaaaaaaaa
aaaaaaaaaaaaaaaaaaabdeeetedbdeeeeeeehbaaaaaaaaaaaaaaaaaaa
aaaaaaaaaaaaaaaaaaabeeeieeubeeeeeeeeebaaaaaaaaaaaaaaaaaaa
aaaaaaaaaaaaaaaaaaabeeeeeeebeeeeeeeeebaaaaaaaaaaaaaaaaaaa
aaaaaaaaaaaaabbbbbbbeeeeeehbeeteeeeedbaaaaaaaaaaaaaaaaaaa
aaaaaaaaaaaaabfccjcbbbbbebbbbbbbbebbbbbbbbbaaaaaaaaaaaaaa
aaaaaabbbbbbbbkccccbeeeeeeeeeeeeeeeeeeeeeebaaaaaaaaaaaaaa
aaaaaabfcccccccccccbeccccccccccccccccccccebaaaaaaaaaaaaaa
aaaaaabflccccccccccbeceeeeeeeeeeeeeeeeeecebaaaaaaaaaaaaaa
aaaaaabfccccccscccceecebbbbbbbbbbbbbbbbecebaaaaaaaaaaaaaa
aaaaaabbbbbbbbbbbbbbecebdddbmeteeeeeeebecebaaaaaaaaaaaaaa
aaaaaabeeeeeeeieeeebecebeeebeeeeeeeeeebecebaaaaaaaaaaaaaa
aaaaaabeeeeeeeeeeeeeecebeetbeeeeneeeeebecebaaaaaaaaaaaaaa
aaaaaabeteedueeeeedbecebeeebbbbddeeeeebecebaaaaaaaaaaaaaa
aaaaaabeeeedeeeeendbectbeeeeeebeeeeeeebecebaaaaaaaaaaaaaa
aaaaaabeeeedeeeedddbecebeeeeeebbbbebbbbecebaaaaaaaaaaaaaa
aaaaaabbbbbbbbbbbbbbeceeeeeeeebeeeeeeobecebaaaaaaaaaaaaaa
aaaaaabdddddddbeeeibecebeeeeeebeeeddpebecebaaaaaaaaaaaaaa
aaaaaabeeeeeeebeddebecebteeeeebeeeddptbecebaaaaaaaaaaaaaa
aaaaaabeeepeeebeddebecebbbbbddbeeeeeeebecebaaaaaaaaaaaaaa
aaaaaabeqeeteebeeeeeecebeeebbbbeeeeeeebecebaaaaaaaaaaaaaa
aaaaaabeqeeebbbbbbbbecebeeeeeeeeeddeeebecebaaaaaaaaaaaaaa
aaaaaabieeeebeeeeeeeeceeeeeddeeeeddeeebecebaaaaaaaaaaaaaa
aaaaaabeeeeeeeccccccccebeeeddeeeeeeeeebeeebaaaaaaaaaaaaaa
aaaaaabdddddbeeeeeeeeeebeeeeeeeeeeeetebeeebaaaaaaaaaaaaaa
aaaaaabbbbbbbbbbbbbbbbbbbbbbbbbbbbbbbbbbbbbaaaaaaaaaaaaaa
aaaaaaaaaaaaaaaaaaaaaaaaaaaaaaaaaaaaaaaaaaaaaaaaaaaaaaaaa
aaaaaaaaaaaaaaaaaaaaaaaaaaaaaaaaaaaaaaaaaaaaaaaaaaaaaaaaa
aaaaaaaaaaaaaaaaaaaaaaaaaaaaaaaaaaaaaaaaaaaaaaaaaaaaaaaaa
aaaaaaaaaaaaaaaaaaaaaaaaaaaaaaaaaaaaaaaaaaaaaaaaaaaaaaaaa
aaaaaaaaaaaaaaaaaaaaaaaaaaaaaaaaaaaaaaaaaaaaaaaaaaaaaaaaa
"}
