"a" = (/obj/structure/frame,/turf/open/floor/plating/asteroid,/area/template_noop)
"b" = (/turf/open/floor/plating/asteroid,/area/template_noop)
"c" = (/obj/structure/fermenting_barrel,/turf/open/floor/plating/asteroid,/area/template_noop)
"d" = (/obj/structure/table/wood,/turf/open/floor/plating/asteroid,/area/template_noop)
"e" = (/obj/structure/frame/computer,/turf/open/floor/plating/asteroid,/area/template_noop)
"f" = (/obj/structure/fence/corner{icon_state = "corner"; dir = 9},/turf/open/floor/plating/asteroid,/area/template_noop)
"g" = (/obj/structure/fence{icon_state = "straight"; dir = 8},/turf/open/floor/plating/asteroid,/area/template_noop)
"h" = (/obj/structure/fence/corner{icon_state = "corner"; dir = 4},/turf/open/floor/plating/asteroid,/area/template_noop)
"i" = (/obj/structure/fence,/turf/open/floor/plating/asteroid,/area/template_noop)
"j" = (/obj/structure/fence{icon_state = "straight"; dir = 1},/turf/open/floor/plating/asteroid,/area/template_noop)
"k" = (/obj/structure/grille,/turf/open/floor/plating/asteroid,/area/template_noop)
"l" = (/obj/structure/closet/crate/trashcart,/turf/open/floor/plating/asteroid,/area/template_noop)
"m" = (/obj/structure/fence/cut/medium,/turf/open/floor/plating/asteroid,/area/template_noop)
"n" = (/obj/structure/fence/corner{icon_state = "corner"; dir = 1},/turf/open/floor/plating/asteroid,/area/template_noop)
"o" = (/obj/structure/fence/cut/medium{icon_state = "straight_cut2"; dir = 8},/turf/open/floor/plating/asteroid,/area/template_noop)
"p" = (/obj/structure/fence/door,/turf/open/floor/plating/asteroid,/area/template_noop)
"q" = (/obj/structure/fence/corner{icon_state = "corner"; dir = 6},/turf/open/floor/plating/asteroid,/area/template_noop)
"r" = (/obj/effect/spawner/lootdrop/barrel/shit,/turf/open/floor/plating/asteroid,/area/template_noop)
"s" = (/obj/effect/spawner/lootdrop/mats,/turf/open/floor/plating/asteroid,/area/template_noop)
"t" = (/obj/effect/spawner/lootdrop/grille_or_trash,/turf/open/floor/plating/asteroid,/area/template_noop)
"u" = (/turf/closed/wall/mineral/iron,/area/template_noop)
"v" = (/obj/effect/spawner/lootdrop/parts,/turf/open/floor/plating/asteroid,/area/template_noop)
"w" = (/obj/structure/rack,/turf/open/floor/plasteel,/area/template_noop)
"x" = (/turf/open/floor/plasteel,/area/template_noop)
"y" = (/obj/structure/filingcabinet/chestdrawer/random,/turf/open/floor/plasteel,/area/template_noop)
"z" = (/obj/structure/dresser,/turf/open/floor/plating/asteroid,/area/template_noop)
"A" = (/obj/machinery/smithy,/turf/open/floor/plasteel,/area/template_noop)
"B" = (/obj/effect/spawner/lootdrop/gloves,/turf/open/floor/plating/asteroid,/area/template_noop)
"C" = (/obj/structure/janitorialcart,/turf/open/floor/plating/asteroid,/area/template_noop)
"D" = (/obj/structure/mineral_door/wood,/turf/open/floor/plating/asteroid,/area/template_noop)
"E" = (/obj/structure/closet/crate/bin,/turf/open/floor/plating/asteroid,/area/template_noop)
"F" = (/obj/structure/closet,/turf/open/floor/plating/asteroid,/area/template_noop)
"G" = (/obj/effect/spawner/lootdrop/glowstick,/turf/open/floor/plating/asteroid,/area/template_noop)
"H" = (/obj/structure/barricade/wooden,/turf/open/floor/plating/asteroid,/area/template_noop)
"I" = (/obj/structure/mopbucket,/turf/open/floor/plating/asteroid,/area/template_noop)
"J" = (/obj/structure/table_frame,/turf/open/floor/plating/asteroid,/area/template_noop)
"K" = (/obj/structure/closet/cardboard,/turf/open/floor/plating/asteroid,/area/template_noop)
"L" = (/obj/structure/piano/unanchored,/turf/open/floor/plating/asteroid,/area/template_noop)
"M" = (/obj/structure/rack,/turf/open/floor/plating/asteroid,/area/template_noop)
"N" = (/obj/effect/spawner/lootdrop/maintenance,/turf/open/floor/plating/asteroid,/area/template_noop)
"O" = (/obj/effect/spawner/lootdrop/crate_spawner,/turf/open/floor/plating/asteroid,/area/template_noop)
"P" = (/obj/item/melee/sabre,/turf/open/floor/plating/asteroid,/area/template_noop)
"Q" = (/obj/item/lipstick/random,/turf/open/floor/plating/asteroid,/area/template_noop)
"R" = (/obj/structure/frame/machine,/turf/open/floor/plating/asteroid,/area/template_noop)
"S" = (/obj/structure/table,/turf/open/floor/plating/asteroid,/area/template_noop)
"T" = (/obj/structure/easel,/turf/open/floor/plating/asteroid,/area/template_noop)
"U" = (/obj/structure/barrel/parts,/turf/open/floor/plasteel,/area/template_noop)
"V" = (/obj/structure/barrel/shit,/turf/open/floor/plasteel,/area/template_noop)
"W" = (/obj/structure/barrel/tool,/turf/open/floor/plating/asteroid,/area/template_noop)

(1,1,1) = {"
bbbbbbbbbbbbbbbbbbbbbbbbbbbbbbbbbbbbbbbbbb
bbfgggggggggggggggggggggggggggggggggggbbbb
bbibbbbbbbbbbbbbbbbbbbbbbbbbbbbbbbbbbbbibb
bbibbbbbbbbbbbbbbbbbbbrbbbbbbbbbbbbbbbbibb
bbibbbbbbbsssbbbbrbbbbbbbbrbbbbbbbbbbbbibb
bbibbbblbbbbbbbbbbbbbbbtttbbbrbbbbrbbbbibb
bbibbbbbbbbbbbbuubbbbbbtttbbbbbrbbbbbbbibb
bbibbbbrbbbbrbbuubbbrbbtttttbbabbbbbbbbibb
bbibbbrrbbbbbbbbbubbbbbabbttbbbbbbrbbbbibb
bbibbbbbsbbbbbbbbbbbbbcbttttbbbbbbbbbbbibb
bbibbbbbbuuuuuuuuuuuubbbtttbrbbbbbbbbbbibb
bbibbvbbbuwwwxxxUyxyubbbtttbbbbrbbrrbbbibb
bbibbbbbbuxxxxxxxxxxubbbtttbbbbbbbbbbbbibb
bbibbbbbbbbxxxxxxxxxubbtttbbbbbbbbbbbbbibb
bbibbbbbbbbbxxxxxxxxubbttttbrbbbbbNNbbbibb
bbibbblbbbbxxxxxxxxxubzbbttbuuubbbNbbbbibb
bbibbbbbbbbbxxxxxAxxubbbbttbubbbrbbbbbbibb
bbibBbbbbuxxxxxxxxxxubCbbbbbuubbbbbbbbbibb
bbibbbbbbuxxxxxxxxxVukkbbbbbbbbbbbbbbbbibb
bbibbbbbbuuDuuuuuuuuuukkkkbbbbbbbbbbbbbibb
bbibbbbbbbbbbbdeurblEuauuuuubFttttbbbbbibb
bbikkbbGbbbbbbbburbbbuuuHlbubbttttbzbbbibb
bbikkblbbbbbbbbrubbbbubbHHHubbttttttbbbibb
bbibbbbbbbbbbbbbubbbIbbbbbbubbbbttttbbbibb
bbibtttbbGbJbbbbbMbbbbbbbbbukbbbbtttbbbibb
bbibttttbbbbbbbbbbbbbubrbuuukbbbbbbbbbbibb
bbibttttbbbGbbbbuRbbbuuuuukkkbbbbbbbbbbibb
bbibttttbbbbbbbbuuuuuulbbbHbHHHHbbbbbbbibb
bbibttttbbkbbbbbbbbbSbbbbbHbbbbHbbbbbbbibb
bbibttttbkkkkkbbbbbMSbKbbbHbbbbHbbbbbbbibb
bbibbtttbbkbazbbbbbbbbbbbbHbbbbHbbbbbbbibb
bbibbtttbbkbbTkbbbbbbLbbbbbbbHHHbbbbbbbibb
bbibbbbbbbbbbIkbbrbbbbbbbbbbbbbbbbbbbbbibb
bbibbbbbbbbbbkkSkkkkkkbbbbuulbbbbbbbbbbibb
bbiggggggggggggggggghkbbbbuuuubbbbbbbbbibb
bbibbbbbbbbbbbrbbbbljkbbbbuubbbbbbbbbbbibb
bbibbbbbbNNNbbbbbbbbjbbbbbuuObbbbbbbbbbibb
bbibkbbbNNbbbbbbbbbbjbbbbbuuNNbbbbbObbbibb
bbibkbbbbbbbbbbbbbbbjbbbbbbubNbbbbbbbbbibb
bbibkbbbblbblbbbbbbbjbbbPbbubbbbbbbbbbbibb
bbibbNbkkbbbbbbbbbrbjbbNbbbbbbbbbbbbbbbibb
bbmbbNbbbbbbbbbbbbbbjbbNNNbbbbbbbNbbbbbibb
bbibbNbbbbbbbbkbbbbbjbbNNNNbQbbbbNbNbbbibb
bbmbbbbNbbbbbbbbbbbbjbbbNNNbbbbbbNNNNbbibb
bbibbbbbNNNbbbbbbbbbjbbbbNbbbbbbbbNbNbbibb
bbibbbbbNNNNNbbbbbbbjbbObbbbbbbbbNNNNbbibb
bbibbbbbbbbNNNbbbbbbjbbWbbbbbbbbbNNbbbbibb
bbibblbbbbbbbbbbbbbbjbbbbbbbNNNbbbNbbbbibb
bbnggoggggggggpgggggqbbbbbbbNbNNbbNbbbbbbb
bbbbbbbbbbbbbbbbbbbbbbbbbNbbNNNNbbbbbbbbbb
bbbbbbNNNNNNNbbbbbbbbbNNNNNbbbbbbbbbbbbbbb
bbbbNNNNNNNNNNNNbbbbbbbbbbbbbbbbbbbbbbbbbb
bbbbNNNNNNNbbbbbbbbbbbbbbbbbbbbbbbbbbbbbbb
"}
