"a" = (/turf/closed/mineral/random,/area/surface/outdoors/underground/loops)
"b" = (/mob/living/simple_animal/hostile/skeleton,/turf/open/floor/plating/asteroid,/area/surface/outdoors/underground/loops)
"c" = (/turf/open/floor/plating/asteroid,/area/surface/outdoors/underground/loops)
"d" = (/obj/item/flashlight/lantern,/turf/open/floor/plating/asteroid,/area/surface/outdoors/underground/loops)
"e" = (/obj/effect/baseturf_helper/asteroid,/turf/open/floor/plating/asteroid,/area/surface/outdoors/underground/loops)

(1,1,1) = {"
aaaaaaaaaaaaaaaaaaabccccccccccaaaaaaaaaa
aaaaaaaaaaaaaaacccccccccccccbcccccaaaaaa
aaaaaaaaaaaacccccccccaaaaaaccccccccaaaaa
aaaaaaaaaaacccccccaaaaaaaaaaaccccccaaaaa
aaaaaaaaaaccccccaaaaaaaaaaaaacccbccaaaaa
aaaaaaaaacccccaaaaaaaaaaaaaaccccccaaaaaa
aaaaaaaaaccccaaaaaaaaaaaaccccccccaaaaaaa
aaaaaaaaacccaaaaaaaaaccccccccccaaaaaaaaa
aaaaaaaaccccaaaaaaaccdcccccccaaaaaaaaaaa
aaaaaaaaccccaaaaaaccccccccbccaaaaaaaaaaa
aaaaaaacbcccccccccccccccccccaaaaaaaaaaaa
aaaaaaccccccccbcccccccccaaaaaaaaaaaaaaaa
aaaaaaccccccccccccccccaaaaaaaaaaaaaaaaaa
aaaaacccccaaaaaccccccaaaaaaaaaaaaaaaaaaa
aaaaccccaaaaaaaaaccccaaaaacccccccccaaaaa
aaaaccccaaaaaaaaaccdcaaccccccccccccccaaa
aaaaccbaaaaaaaaaaccccccccccccccccccccaaa
aaaccccaaaaaaaaacccccccccccaaacccccccaaa
aaaccccaaaaaaaaaccccccccaaaaaaaacdccccaa
aaaccccaaaaaaaaaccccccaaaaaaaaaaacccccca
aaaaccccaaaaaaaacccccaaaaaaaaaaaaaccccca
aaaaccccaaaaaaaccccccaaaaaaaaaaaaacccccc
aaaabcccaaaaaaccccbccaaaaaaaaaaaaaaccccc
aaaaccccaaaccccccccccaaaaaaaaaaaaaaacccc
aaaaacccaacccccccccccaaaaaaaaaaaaaaacccc
aaaaaccccccccccaaaccaaaaaaaaaaaaaaaacccc
aaaaaacccccccaaaaccccaaaaaaaaaaaaaaaaccc
aaaaaacccccccaaaacccccccccaaaaaaaaaaaccc
aaaaaacccccaaaaacecccccccccccccaaaaacccc
aaaaaaaccccaaaacccccccbccccccccaaaaacccc
aaaaaaacccaaaaccccaaccccccccccccaaaacccc
aaaaaaccccaaaccccaaaaaaaaaacccccaaaccccc
aaaaaacccaaaccccaaaaaaaaaaaaccccaaacccca
aaaaaccccaacccccaaaaaaaaaaaaccccaaacccca
aaaaaccccccccccaaaaaaaaaaaaaccccaaccccca
aaaacccccccccaaaaaaaaaaaaaaaaccccaccccca
aaaaacbccccaaaaaaaaaaaaaaaaaacccccccccaa
aaaaaaccccaaaaaaaaaaaaaaaaaaaaccccccccaa
aaaaaaaaaaaaaaaaaaaaaaaaaaaaaaaccccbccaa
aaaaaaaaaaaaaaaaaaaaaaaaaaaaaaaaaaaaaaaa
"}
