"a" = (/turf/closed/wall/mineral/wood/nonmetal,/area/surface/outdoors/underground/ruin/rec)
"b" = (/turf/open/floor/wood,/area/surface/outdoors/underground/ruin/rec)
"c" = (/obj/effect/decal/cleanable/dirt/dust,/obj/effect/decal/cleanable/cobweb,/turf/open/floor/wood,/area/surface/outdoors/underground/ruin/rec)
"d" = (/obj/effect/decal/cleanable/dirt/dust,/turf/open/floor/wood,/area/surface/outdoors/underground/ruin/rec)
"e" = (/obj/structure/chair/stool/bar,/obj/effect/decal/cleanable/dirt/dust,/turf/open/floor/wood,/area/surface/outdoors/underground/ruin/rec)
"f" = (/obj/structure/table/wood,/obj/effect/decal/cleanable/dirt/dust,/turf/open/floor/wood,/area/surface/outdoors/underground/ruin/rec)
"g" = (/obj/structure/table/wood,/obj/item/reagent_containers/food/drinks/drinkingglass,/obj/item/reagent_containers/food/drinks/ale{step_x = -9; step_y = 3},/obj/effect/decal/cleanable/dirt/dust,/obj/effect/decal/cleanable/cobweb/cobweb2,/turf/open/floor/wood,/area/surface/outdoors/underground/ruin/rec)
"h" = (/obj/structure/punching_bag,/obj/effect/decal/cleanable/dirt/dust,/turf/open/floor/wood,/area/surface/outdoors/underground/ruin/rec)
"i" = (/obj/structure/weightmachine/stacklifter,/obj/effect/decal/cleanable/dirt/dust,/turf/open/floor/wood,/area/surface/outdoors/underground/ruin/rec)
"j" = (/obj/item/reagent_containers/food/drinks/beer{step_x = 31},/obj/effect/decal/cleanable/dirt/dust,/turf/open/floor/wood,/area/surface/outdoors/underground/ruin/rec)
"k" = (/obj/structure/table/wood,/obj/item/reagent_containers/food/drinks/beer{step_x = -7; step_y = 4},/obj/item/reagent_containers/food/drinks/beer{step_x = 7; step_y = 5},/obj/effect/decal/cleanable/dirt/dust,/turf/open/floor/wood,/area/surface/outdoors/underground/ruin/rec)
"l" = (/obj/effect/baseturf_helper/asteroid,/obj/effect/decal/cleanable/dirt/dust,/turf/open/floor/wood,/area/surface/outdoors/underground/ruin/rec)
"m" = (/obj/structure/table/wood,/obj/item/reagent_containers/food/drinks/beer{step_x = 6; step_y = 5},/obj/item/reagent_containers/food/drinks/beer{step_x = -6; step_y = 5},/obj/item/reagent_containers/food/drinks/ale{step_x = -6; step_y = 2},/obj/item/reagent_containers/food/drinks/ale{step_x = 1; step_y = 0},/obj/effect/decal/cleanable/dirt/dust,/turf/open/floor/wood,/area/surface/outdoors/underground/ruin/rec)
"n" = (/obj/structure/weightmachine/weightlifter,/obj/effect/decal/cleanable/dirt/dust,/turf/open/floor/wood,/area/surface/outdoors/underground/ruin/rec)
"o" = (/obj/structure/table/wood,/obj/item/reagent_containers/food/drinks/bottle/whiskey{step_x = -7; step_y = 8},/obj/item/reagent_containers/food/drinks/bottle/whiskey{step_x = 2; step_y = 5},/obj/effect/decal/cleanable/dirt/dust,/turf/open/floor/wood,/area/surface/outdoors/underground/ruin/rec)
"p" = (/obj/structure/chair/wood,/obj/effect/decal/cleanable/dirt/dust,/turf/open/floor/wood,/area/surface/outdoors/underground/ruin/rec)
"q" = (/obj/structure/table/wood,/obj/item/reagent_containers/food/drinks/bottle/small{step_x = 7; step_y = 6},/obj/item/reagent_containers/food/drinks/bottle/small{step_x = -7; step_y = 0},/obj/effect/decal/cleanable/dirt/dust,/turf/open/floor/wood,/area/surface/outdoors/underground/ruin/rec)
"r" = (/obj/structure/chair/wood{icon_state = "wooden_chair"; dir = 4},/obj/effect/decal/cleanable/dirt/dust,/turf/open/floor/wood,/area/surface/outdoors/underground/ruin/rec)
"s" = (/obj/structure/table/wood/poker,/obj/effect/spawner/lootdrop/maintenance,/obj/effect/decal/cleanable/dirt/dust,/turf/open/floor/wood,/area/surface/outdoors/underground/ruin/rec)
"t" = (/obj/structure/table/wood/poker,/obj/effect/decal/cleanable/dirt/dust,/turf/open/floor/wood,/area/surface/outdoors/underground/ruin/rec)
"u" = (/obj/structure/chair/wood{icon_state = "wooden_chair"; dir = 8},/obj/effect/decal/cleanable/dirt/dust,/turf/open/floor/wood,/area/surface/outdoors/underground/ruin/rec)
"v" = (/obj/structure/table/wood,/obj/effect/spawner/lootdrop/maintenance,/obj/effect/decal/cleanable/dirt/dust,/turf/open/floor/wood,/area/surface/outdoors/underground/ruin/rec)
"w" = (/obj/effect/decal/cleanable/dirt/dust,/obj/effect/decal/cleanable/shreds,/turf/open/floor/wood,/area/surface/outdoors/underground/ruin/rec)
"x" = (/obj/structure/chair/wood{icon_state = "wooden_chair"; dir = 1},/obj/effect/decal/cleanable/dirt/dust,/turf/open/floor/wood,/area/surface/outdoors/underground/ruin/rec)
"y" = (/obj/structure/piano{icon_state = "piano"},/obj/effect/decal/cleanable/dirt/dust,/turf/open/floor/wood,/area/surface/outdoors/underground/ruin/rec)

(1,1,1) = {"
aaaaaaaabbaaaaaa
acddddddddefddga
bdhdidddddefdjka
addddddddlefddma
adndddddddefddoa
adddddpppdefddqa
addddrsstuefddfa
addddrstsudvfdfa
bdwdddxxxdddddda
addddddddddddddb
adddddddddddddda
ayddddddddddddda
aaaaaaabaaaaaaaa
"}
