"a" = (/turf/template_noop,/area/template_noop)
"b" = (/turf/open/floor/plating/asteroid,/area/template_noop)
"c" = (/obj/structure/flora/rock,/turf/open/floor/plating/asteroid,/area/template_noop)
"d" = (/obj/structure/flora/rock,/turf/template_noop,/area/template_noop)
"e" = (/obj/structure/ladder,/turf/open/floor/plating/asteroid,/area/template_noop)
"f" = (/turf/open/transparent/openspace,/area/template_noop)
"r" = (/turf/open/space/basic,/area/space)

(1,1,1) = {"
bbbbbbbbbbbbbbbbbbbbbbbbbbbbbbbbbbbbbbbbbbbb
bbbbbbbbbbbbbbbbbbbbbbbbbbbbbbbbbbbbbbbbbbbb
bbbbbbbbbbbbbbbbbbbbbbbbbbbbbbbbbbbbbbbbbbbb
bbbbbbbbbbbbbbbbbbbbbbbbbbbbbbbbbbbbfbbbbbbb
bbbbbbbbbbbbbbbbbbbbbfbbbbbbbbbbbbbfbbbbbbbb
bbbbbbbbbbffbbbbbbbffffffbbbbbffbfffbbbbbbbb
bbbbbfbfffffffbbbbbbffffffffffffffffbbbbbbbb
bbbbbffffffffbbbbbbbbbbffffffffffffffbbbbbbb
bbbbbffffffbbbbbbbbbbbbbbbffffffffffffbbbbbb
bbbbbfffffbbbbbbbbbbbbbbbbbfffffffffffbbbbbb
bbbbbfffffbbbbbbbbbbbbbbbffffffffffbfffbbbbb
bbbbfffffbbbbbbbbbffffffffffffffbbbbbffbbbbb
bbbbfffffbbbbbbfffffffffffffffbbbbbbbfffbbbb
bbbffffffbffffffffffffffffffbbbbbbbbbfffbbbb
bfffffffffffffffffffffffffbbbbbbbbbbbbbffbbb
bfffffffffffffffffffffffffbbbbbbbbbbbbbbfbbb
bbbfffffffffffffffffffffbfbbbbbbbbbbbbbbbbbb
bbffffffbbbbbbbffffffffbbfbbbbbbbbbbbbbbbbbb
bbbffbbbbbbbbbfffffffbfbbbbbbbbbbbbbbffbbbbb
bbbffbbbbbbbbbffffbfbbfbbbbbbbbbbbbbfffffbbb
bbbbfbbbbbbbbbbfffbbbbbbbbbbbbbbbbbfffffffbb
bbbbbbbbbbbbbbbffffbbbbbbbbbbbbbbbbfffffffbb
bbbbbbbbbbbbbbbffffbbbbbbbbbbbbbbbffffffffbb
bbbbbbbbbbbbbbfffffbbbbbbbbbbbbbbfffffffffbb
bbbbbbbbbbbbbbfffffbbbbbbbbbbbbbbfffffffffbb
bbbbbbbbbbbbbbbfffffbbbbbbbbffbfffffffffffbb
bbbbfffffffffffffffffffbfffffffffffffffffffb
fffbfffffffffffffffffffffffffffffffffffffbbb
fffffffffffffffbfffffffffffffffffffffffbbbbb
bbbbbbfffffffffbfffffffffffffffffffffbbbbbbb
bbbbbbbbbbbbbbbbbbbffffffffffffbbbbbbbbbbbbb
bbbbbbbbbbbbbbbbbbbbfffbbbbbbbbbbbbbbbbbbbbb
"}

(1,1,2) = {"
rrrrrrrrrrrrrrrrrrrrrrrrrrrrrrrrrrrrrrrrrrrr
rrrrrrrrrrrrrrrrrrrrrrrrrrrrrrrrrrrrrrrrrrrr
rrrrrrrrrrrrrrrrrrrrrrrrrrrrrrrrrrrrrrrrrrrr
rrrrrrrrrrrrrrrrrrrrrrrrrrrrrrrrrrrrrrrrrrrr
rrrrrrrrrrrrrrrrrrrrrrrrrrrrrrrrrrrrrrrrrrrr
rrrrrrrrrrrrrrrrrrrrrrrrrrrrrrrrrrrrrrrrrrrr
rrrrrrrrrrrrrrrrrrrrrrrrrrrrrrrrrrrrrrrrrrrr
rrrrrrrrrrrrrrrrrrrrrrrrrrrrrrrrrrrrrrrrrrrr
rrrrrrrrrrrrrrrrrrrrrrrrrrrrrrrrrrrrrrrrrrrr
rrrrrrrrrrrrrrrrrrrrrrrrrrrrrrrrrrrrrrrrrrrr
rrrrrrrrrrrrrrrrrrrrrrrrrrrrrrrrrrrrrrrrrrrr
aaaaaaaaaaaaaaaaaaaaaaarrrrrrrrrrrrrrrrrrrrr
aaaaaaaaaaaaaaaaaaaaaaarrrrrrrrrrrrrrrrrrrrr
aaaaaaaaaaaaaaaaaaaaaaarrrrrrrrrrrrrrrrrrrrr
aaaaaaaaaaaaaaaaaaaaaaarrrrrrrrrrrrrrrrrrrrr
aaaaaaaaaaaaaaaaaaaaaaarrrrrrrrrrrrrrrrrrrrr
aaaaaaaaaaacaaaaaaaaaaarrrrrrrrrrrrrrrrrrrrr
aaaaaaaababbadbaaaaaaaarrrrrrrrrrrrrrrrrrrrr
aaaaaaaaabbbbbaaaaaaaaarrrrrrrrrrrrrrrrrrrrr
aaaaaaadaabbcaabaaaaaaarrrrrrrrrrrrrrrrrrrrr
aaaaaaabbbcbbbbbaaaaaaarrrrrrrrrrrrrrrrrrrrr
aaaaaaaaaabebcaaaaaaaaarrrrrrrrrrrrrrrrrrrrr
aaaaaaababbbbbbbaaaaaaarrrrrrrrrrrrrrrrrrrrr
aaaaaabbcbbbcbadbaaaaaarrrrrrrrrrrrrrrrrrrrr
aaaaaaaaaabbbbbcbaaaaaarrrrrrrrrrrrrrrrrrrrr
aaaaaaaabbbbaabaaaaaaaarrrrrrrrrrrrrrrrrrrrr
aaaaaaaaacacaaaaaaaaaaarrrrrrrrrrrrrrrrrrrrr
aaaaaaaabaaaaaaaaaaaaaarrrrrrrrrrrrrrrrrrrrr
aaaaaaaaaaaaaaaaaaaaaaarrrrrrrrrrrrrrrrrrrrr
aaaaaaaaaaaaaaaaaaaaaaarrrrrrrrrrrrrrrrrrrrr
aaaaaaaaaaaaaaaaaaaaaaarrrrrrrrrrrrrrrrrrrrr
aaaaaaaaaaaaaaaaaaaaaaarrrrrrrrrrrrrrrrrrrrr
"}
