"a" = (/turf/template_noop,/area/template_noop)
"b" = (/turf/closed/mineral/random/no_caves,/area/template_noop)
"c" = (/turf/closed/wall/rust,/area/template_noop)
"d" = (/obj/effect/decal/cleanable/cobweb,/obj/effect/decal/cleanable/dirt/dust,/turf/open/floor/plating/pavement/sidewalk,/area/template_noop)
"e" = (/obj/item/reagent_containers/glass/bottle,/obj/effect/decal/cleanable/dirt/dust,/turf/open/floor/plating/pavement/sidewalk,/area/template_noop)
"f" = (/obj/effect/decal/cleanable/dirt/dust,/obj/item/reagent_containers/food/snacks/meat/slab/human/mutant/skeleton,/obj/effect/decal/cleanable/blood/old,/turf/open/floor/plating/pavement/sidewalk,/area/template_noop)
"g" = (/obj/effect/decal/cleanable/vomit/old,/obj/effect/decal/cleanable/dirt/dust,/turf/open/floor/plating/pavement/sidewalk,/area/template_noop)
"h" = (/obj/effect/decal/cleanable/dirt/dust,/obj/item/folder,/turf/open/floor/plating/pavement/sidewalk,/area/template_noop)
"i" = (/obj/effect/decal/cleanable/dirt/dust,/obj/item/stack/sheet/mineral/wood,/turf/open/floor/plating/pavement/sidewalk,/area/template_noop)
"j" = (/obj/effect/decal/cleanable/dirt/dust,/obj/item/stack/sheet/plastic,/turf/open/floor/plating/pavement/sidewalk,/area/template_noop)
"k" = (/obj/effect/decal/cleanable/dirt/dust,/turf/open/floor/plating/pavement/sidewalk,/area/template_noop)
"l" = (/obj/effect/decal/cleanable/cobweb/cobweb2,/obj/effect/decal/cleanable/dirt/dust,/turf/open/floor/plating/pavement/sidewalk,/area/template_noop)
"m" = (/obj/effect/decal/cleanable/dirt/dust,/obj/effect/decal/cleanable/glass,/turf/open/floor/plating/pavement/sidewalk,/area/template_noop)
"n" = (/obj/effect/decal/cleanable/dirt/dust,/obj/effect/decal/remains/human,/turf/open/floor/plating/pavement/sidewalk,/area/template_noop)
"o" = (/obj/effect/decal/cleanable/dirt/dust,/obj/item/hammer,/turf/open/floor/plating/pavement/sidewalk,/area/template_noop)
"p" = (/obj/effect/decal/cleanable/dirt/dust,/obj/effect/decal/cleanable/generic,/turf/open/floor/plating/pavement/sidewalk,/area/template_noop)
"q" = (/obj/effect/decal/cleanable/dirt/dust,/obj/effect/decal/cleanable/glass,/obj/item/stack/sheet/mineral/wood,/turf/open/floor/plating/pavement/sidewalk,/area/template_noop)
"r" = (/obj/effect/decal/cleanable/dirt/dust,/turf/open/floor/plating/rust,/area/template_noop)
"s" = (/obj/effect/decal/cleanable/dirt/dust,/obj/effect/decal/cleanable/glass,/obj/item/wirecutters,/turf/open/floor/plating/pavement/sidewalk,/area/template_noop)
"t" = (/obj/effect/decal/cleanable/dirt/dust,/obj/item/flashlight/seclite,/turf/open/floor/plating/pavement/sidewalk,/area/template_noop)
"u" = (/obj/effect/decal/cleanable/dirt/dust,/obj/item/stack/brick,/turf/open/floor/plating/pavement/sidewalk,/area/template_noop)
"v" = (/obj/effect/decal/cleanable/dirt/dust,/obj/item/light/tube/broken,/turf/open/floor/plating/pavement/sidewalk,/area/template_noop)
"w" = (/obj/effect/decal/cleanable/dirt/dust,/obj/structure/chair/plastic{icon_state = "plastic_chair"; dir = 4},/turf/open/floor/plating/pavement/sidewalk,/area/template_noop)
"x" = (/turf/open/floor/plating/pavement/sidewalk,/area/template_noop)
"y" = (/obj/effect/decal/cleanable/dirt/dust,/obj/item/card/data/disk,/turf/open/floor/plating/pavement/sidewalk,/area/template_noop)
"z" = (/obj/effect/decal/cleanable/dirt/dust,/obj/machinery/light/broken,/turf/open/floor/plating/pavement/sidewalk,/area/template_noop)
"A" = (/obj/effect/decal/cleanable/dirt/dust,/obj/item/radio/off,/turf/open/floor/plating/pavement/sidewalk,/area/template_noop)
"B" = (/obj/effect/decal/cleanable/dirt/dust,/obj/machinery/vending/snack,/turf/open/floor/plating/pavement/sidewalk,/area/template_noop)
"C" = (/obj/effect/decal/cleanable/dirt/dust,/turf/closed/mineral/random/no_caves,/area/template_noop)
"D" = (/obj/effect/decal/cleanable/dirt/dust,/obj/structure/barricade/wooden,/turf/open/floor/plating/pavement/sidewalk,/area/template_noop)
"E" = (/obj/effect/decal/cleanable/dirt/dust,/obj/effect/decal/cleanable/blood/old,/turf/open/floor/plating/pavement/sidewalk,/area/template_noop)
"F" = (/obj/effect/decal/cleanable/dirt/dust,/obj/item/reagent_containers/food/snacks/meat/slab/human/mutant/skeleton,/turf/open/floor/plating/pavement/sidewalk,/area/template_noop)

(1,1,1) = {"
aaaaaaaaaaaaaaaaaaaaaaaaaaaaaa
aabbbbaabbbbbbbccccccccccbbbaa
bbbbbbbbbbbbbbbcbbbbbbbbcbbbaa
bccbbbbccccccccccccccccbcaabaa
bcdekfgkhijkkkkkkkkkklcccccccc
bckkkkkkkkkkskkknkktuvckvkkkDc
bcwkokekpEkkkkkFkknkkkxkykkkkc
bckkkzkkmzkkqkFknkkkkkckkkAkkc
bccccccxccccccccccrrrrckkkkkkc
bbbbckkkkBkkcbbbbbCCCCcccccccc
bbbbckkkkkkkcbbbbbCCCCbbaaaabb
bbbbckkkkkkkcbbbbbbbbbbbaaaaba
bbbbccckcccccbbbbbbbbbbbbbbbba
"}
