"a" = (/turf/template_noop,/area/template_noop)
"b" = (/turf/open/floor/plating/asteroid,/area/template_noop)
"c" = (/obj/structure/spawner/nether,/turf/open/floor/plating/asteroid,/area/template_noop)

(1,1,1) = {"
aaaaaaaaaa
aaaaaaabba
aaaaabbbbb
abbbbbbbbb
bbbbbbbbbb
bbbbbbbbba
bbbbcbbbba
abbbbbbbaa
aabbbbbaaa
aaabbbaaaa
aaabbbbaaa
aaabbbbbaa
aaabbbbbaa
aaaabbbaaa
"}
