"a" = (/turf/template_noop,/area/template_noop)
"b" = (/turf/closed/mineral/random/no_caves,/area/template_noop)
"c" = (/turf/closed/wall/rust,/area/template_noop)
"d" = (/obj/effect/decal/cleanable/cobweb,/obj/effect/decal/cleanable/dirt/dust,/turf/open/floor/plating/pavement/sidewalk,/area/template_noop)
"e" = (/obj/item/reagent_containers/glass/bottle,/obj/effect/decal/cleanable/dirt/dust,/turf/open/floor/plating/pavement/sidewalk,/area/template_noop)
"f" = (/obj/effect/decal/cleanable/dirt/dust,/turf/open/floor/plating/pavement/sidewalk,/area/template_noop)
"g" = (/obj/effect/decal/cleanable/vomit/old,/obj/effect/decal/cleanable/dirt/dust,/turf/open/floor/plating/pavement/sidewalk,/area/template_noop)
"h" = (/obj/effect/decal/cleanable/dirt/dust,/obj/item/folder,/turf/open/floor/plating/pavement/sidewalk,/area/template_noop)
"i" = (/obj/effect/decal/cleanable/dirt/dust,/obj/item/stack/sheet/mineral/wood,/turf/open/floor/plating/pavement/sidewalk,/area/template_noop)
"j" = (/obj/effect/decal/cleanable/dirt/dust,/obj/item/stack/sheet/plastic,/turf/open/floor/plating/pavement/sidewalk,/area/template_noop)
"k" = (/obj/effect/decal/cleanable/dirt/dust,/turf/closed/wall/rust,/area/template_noop)
"l" = (/obj/effect/decal/cleanable/cobweb/cobweb2,/obj/effect/decal/cleanable/dirt/dust,/turf/open/floor/plating/pavement/sidewalk,/area/template_noop)
"m" = (/obj/effect/decal/cleanable/dirt/dust,/obj/effect/decal/cleanable/glass,/turf/open/floor/plating/pavement/sidewalk,/area/template_noop)
"n" = (/obj/item/stack/cable_coil/cut,/turf/closed/mineral/random/no_caves,/area/template_noop)
"o" = (/obj/effect/decal/cleanable/dirt/dust,/obj/item/hammer,/turf/open/floor/plating/pavement/sidewalk,/area/template_noop)
"p" = (/obj/effect/decal/cleanable/dirt/dust,/obj/effect/decal/cleanable/generic,/turf/open/floor/plating/pavement/sidewalk,/area/template_noop)
"q" = (/obj/effect/decal/cleanable/dirt/dust,/obj/effect/decal/cleanable/glass,/obj/item/stack/sheet/mineral/wood,/turf/open/floor/plating/pavement/sidewalk,/area/template_noop)
"r" = (/obj/effect/decal/cleanable/dirt/dust,/turf/open/floor/plating/rust,/area/template_noop)

(1,1,1) = {"
aaaaaaaaaaaaaaaaaaaaaaaaaaaaaa
aabbbbaabbbbbbbccccccccccbbbaa
bbbbbbbbbbbbbbbcbbbbbbbbcbbbaa
bccbbbbccccccccccccccccbcaabaa
bcdeffgfhijfffkfffffflcbcaabba
bcffffffffffmfkfffffffcncaaaab
bcffofefpfffffffffffffcbcaaaaa
bcffffffmfffqfkfffffffcbcaaaaa
bccccccfccccccccccrrrrcaaaaaaa
bbbbcfffffffcbbbbcrrrrcaaaaaaa
bbbbcfffffffcbbbbcrrrrcaaaaabb
bbbbcfffffffcbbbbccccccaaaaaba
bbbbcccfcccccbbbbbbbbbbbbbbbba
"}
