"a" = (/turf/closed/wall/mineral/iron,/area/sciencehq)
"b" = (/turf/open/floor/plasteel/checker,/area/sciencehq)
"c" = (/obj/machinery/power/apc/auto_name/north,/turf/open/floor/plasteel/checker,/area/sciencehq)
"d" = (/obj/machinery/conveyor/auto{icon_state = "conveyor_map"; dir = 4},/turf/open/floor/plasteel/checker,/area/sciencehq)
"e" = (/obj/machinery/transformer,/turf/open/floor/plasteel/checker,/area/sciencehq)

(1,1,1) = {"
aaaaaaaaa
abcbbbbba
abbbbbbba
bbbdedbbb
abbbbbbba
abbbbbbba
aaaaaaaaa
"}
