"a" = (/turf/closed/wall/mineral/iron,/area/template_noop)
"b" = (/turf/open/floor/plasteel/checker,/area/template_noop)
"c" = (/turf/open/floor/circuit,/area/template_noop)
"d" = (/obj/machinery/anomalous_crystal/refresher,/turf/open/floor/circuit/red/anim,/area/template_noop)

(1,1,1) = {"
aaaaaaaaa
abbbbbbba
abbcccbba
bbbcdcbbb
abbcccbba
abbbbbbba
aaaaaaaaa
"}
