"a" = (/turf/template_noop,/area/template_noop)
"b" = (/turf/open/water,/area/template_noop)
"c" = (/obj/structure/glowshroom,/turf/open/water,/area/template_noop)

(1,1,1) = {"
aaaaaaaaaaaa
aaaaaaaaaaaa
aaaacbbaaaaa
aaabbbcbcbaa
aabcbbbbbbaa
aabbbcbcbcaa
aaacbbbbbbaa
aaaabcbbcaaa
aaaaaaaaaaaa
"}
