"a" = (/turf/template_noop,/area/template_noop)
"b" = (/turf/open/floor/plating/asteroid,/area/template_noop)
"c" = (/obj/effect/decal/cleanable/blood/old{icon_state = "floor3-old"},/turf/open/floor/plating/asteroid,/area/template_noop)
"d" = (/obj/effect/decal/cleanable/blood/old,/turf/open/floor/plating/asteroid,/area/template_noop)
"e" = (/obj/effect/decal/cleanable/blood/old{icon_state = "floor7-old"},/turf/open/floor/plating/asteroid,/area/template_noop)

(1,1,1) = {"
aaaaaaaaaa
aaaaaaabba
aaaaabbbbb
abbbbbbbbb
bbbbbbbbbb
bbcbbbbbba
bbbbdbebba
abbbbbbbaa
aabbbbbaaa
aaabbbaaaa
aaabbbbaaa
aaabbbbbaa
aaabbbbbaa
aaaabbbaaa
"}
