"a" = (/turf/template_noop,/area/template_noop)
"b" = (/turf/closed/mineral/random/no_caves,/area/template_noop)
"c" = (/turf/closed/wall/rust,/area/template_noop)
"d" = (/obj/effect/decal/cleanable/ash{step_x = -4; step_y = 2},/obj/effect/decal/cleanable/ash{step_x = 5; step_y = 11},/obj/effect/decal/cleanable/dirt/dust,/obj/effect/decal/cleanable/dirt/dust,/turf/open/floor/plating/pavement/sidewalk,/area/template_noop)
"e" = (/obj/effect/decal/cleanable/dirt/dust,/obj/effect/decal/cleanable/dirt/dust,/turf/open/floor/plating/pavement/sidewalk,/area/template_noop)
"f" = (/obj/effect/decal/cleanable/ash{step_x = 17; step_y = 11},/turf/closed/wall/rust,/area/template_noop)
"g" = (/obj/effect/decal/cleanable/ash{step_x = 4; step_y = -5},/obj/effect/decal/cleanable/ash{step_x = -6; step_y = -2},/obj/effect/decal/cleanable/ash{step_x = -6; step_y = -8},/obj/effect/decal/cleanable/ash{step_x = 13; step_y = 8},/obj/effect/decal/cleanable/dirt/dust,/obj/effect/decal/cleanable/dirt/dust,/obj/effect/decal/cleanable/dirt/dust,/turf/open/floor/plating/pavement/sidewalk,/area/template_noop)
"h" = (/obj/effect/decal/cleanable{step_x = 23; step_y = 2},/obj/effect/decal/cleanable/dirt/dust,/obj/effect/decal/cleanable/dirt/dust,/obj/effect/decal/cleanable/dirt/dust,/obj/effect/decal/cleanable/dirt/dust,/turf/open/floor/plating/pavement/sidewalk,/area/template_noop)
"i" = (/obj/effect/decal/cleanable{step_x = 16; step_y = 1},/obj/effect/decal/cleanable/ash{step_x = 20; step_y = 25},/obj/effect/decal/cleanable/blood/old{icon_state = "floor2-old"},/obj/effect/decal/cleanable/dirt/dust,/obj/effect/decal/cleanable/dirt/dust,/obj/effect/decal/cleanable/dirt/dust,/obj/effect/decal/cleanable/dirt/dust,/turf/open/floor/plating/pavement/sidewalk,/area/template_noop)
"j" = (/obj/effect/decal/cleanable/dirt/dust,/obj/effect/decal/cleanable/dirt/dust,/obj/effect/decal/cleanable/dirt/dust,/turf/open/floor/plating/pavement/sidewalk,/area/template_noop)
"k" = (/obj/effect/decal/cleanable/dirt/dust,/turf/open/floor/plating/pavement/sidewalk,/area/template_noop)
"l" = (/obj/effect/decal/cleanable/blood/old{icon_state = "floor3-old"},/obj/effect/decal/cleanable/dirt/dust,/obj/effect/decal/cleanable/dirt/dust,/turf/open/floor/plating/pavement/sidewalk,/area/template_noop)
"m" = (/obj/effect/decal/cleanable/ash{step_x = 7; step_y = 8},/obj/effect/decal/cleanable/dirt/dust,/turf/open/floor/plating/pavement/sidewalk,/area/template_noop)
"n" = (/obj/effect/decal/cleanable/ash{step_x = 6; step_y = -6},/obj/effect/decal/cleanable/dirt/dust,/turf/open/floor/plating/pavement/sidewalk,/area/template_noop)
"o" = (/obj/effect/decal/cleanable/ash{step_x = 10; step_y = 5},/obj/effect/decal/cleanable/dirt/dust,/turf/open/floor/plating/pavement/sidewalk,/area/template_noop)
"p" = (/obj/effect/decal/cleanable/ash{step_x = 11; step_y = 25},/obj/effect/decal/cleanable/dirt/dust,/turf/open/floor/plating/pavement/sidewalk,/area/template_noop)
"q" = (/obj/effect/decal/cleanable/ash{step_x = 31; step_y = 1},/obj/effect/decal/cleanable/ash{step_x = 28; step_y = 3},/obj/effect/decal/cleanable/ash{step_x = 29; step_y = 10},/obj/effect/decal/cleanable/ash{step_x = 17; step_y = 2},/turf/closed/wall/rust,/area/template_noop)
"r" = (/obj/effect/decal/cleanable/dirt/dust,/turf/open/floor/plating/rust,/area/template_noop)
"s" = (/obj/effect/decal/cleanable/ash{step_x = -6; step_y = -8},/obj/effect/decal/cleanable/ash{step_x = 6; step_y = -6},/obj/effect/decal/cleanable/ash{step_x = -1; step_y = -2},/obj/effect/decal/cleanable/ash{step_x = 10; step_y = 8},/obj/effect/decal/cleanable/ash{step_x = 2; step_y = 4},/obj/effect/decal/cleanable/ash{step_x = 27; step_y = 2},/obj/effect/decal/cleanable/dirt/dust,/obj/effect/decal/cleanable/dirt/dust,/obj/effect/decal/cleanable/dirt/dust,/obj/effect/decal/cleanable/dirt/dust,/turf/open/floor/plating/pavement/sidewalk,/area/template_noop)
"t" = (/obj/effect/decal/cleanable/ash{step_x = -6; step_y = -8},/obj/effect/decal/cleanable/ash{step_x = 8; step_y = 5},/obj/effect/decal/cleanable/ash{step_x = 0; step_y = 25},/obj/effect/decal/cleanable/dirt/dust,/obj/effect/decal/cleanable/dirt/dust,/obj/effect/decal/cleanable/dirt/dust,/obj/effect/decal/cleanable/dirt/dust,/obj/effect/decal/cleanable/dirt/dust,/turf/open/floor/plating/pavement/sidewalk,/area/template_noop)
"u" = (/obj/effect/decal/cleanable/ash{step_x = 4; step_y = 11},/obj/effect/decal/cleanable/dirt/dust,/obj/effect/decal/cleanable/dirt/dust,/obj/effect/decal/cleanable/dirt/dust,/obj/effect/decal/cleanable/dirt/dust,/obj/effect/decal/cleanable/dirt/dust,/turf/open/floor/plating/pavement/sidewalk,/area/template_noop)
"v" = (/obj/effect/decal/cleanable/dirt/dust,/obj/item/light/tube/broken,/obj/effect/decal/cleanable/dirt/dust,/turf/open/floor/plating/pavement/sidewalk,/area/template_noop)
"w" = (/obj/effect/decal/cleanable/ash{step_x = -5; step_y = 4},/obj/effect/decal/cleanable/dirt/dust,/obj/effect/decal/cleanable/dirt/dust,/obj/effect/decal/cleanable/dirt/dust,/obj/effect/decal/cleanable/dirt/dust,/turf/open/floor/plating/pavement/sidewalk,/area/template_noop)
"x" = (/obj/effect/decal/cleanable/dirt/dust,/obj/item/radio/off,/obj/effect/decal/cleanable/dirt/dust,/turf/open/floor/plating/pavement/sidewalk,/area/template_noop)
"y" = (/obj/effect/decal/cleanable/dirt/dust,/obj/item/card/data/disk,/turf/open/floor/plating/pavement/sidewalk,/area/template_noop)
"z" = (/obj/effect/decal/cleanable/ash{step_x = 28; step_y = 0},/obj/effect/decal/cleanable/dirt/dust,/obj/effect/decal/cleanable/dirt/dust,/turf/open/floor/plating/pavement/sidewalk,/area/template_noop)
"A" = (/obj/effect/decal/cleanable/dirt/dust,/obj/effect/decal/cleanable/dirt/dust,/obj/effect/decal/cleanable/dirt/dust,/obj/effect/decal/cleanable/dirt/dust,/turf/open/floor/plating/pavement/sidewalk,/area/template_noop)
"B" = (/obj/effect/decal/cleanable/blood/old{step_x = 0; step_y = 0},/obj/effect/decal/cleanable/dirt/dust,/obj/effect/decal/cleanable/dirt/dust,/turf/open/floor/plating/pavement/sidewalk,/area/template_noop)
"C" = (/obj/effect/decal/cleanable/ash{step_x = 7; step_y = 25},/obj/effect/decal/cleanable/dirt/dust,/obj/effect/decal/cleanable/dirt/dust,/turf/open/floor/plating/pavement/sidewalk,/area/template_noop)
"D" = (/obj/effect/decal/cleanable/dirt/dust,/obj/structure/barricade/wooden,/turf/open/floor/plating/pavement/sidewalk,/area/template_noop)
"E" = (/obj/effect/decal/cleanable/ash{step_x = 29; step_y = 31},/obj/effect/decal/cleanable/ash{step_x = 18; step_y = 20},/turf/closed/wall/rust,/area/template_noop)
"F" = (/obj/effect/decal/cleanable/ash{step_x = -1; step_y = -2},/obj/effect/decal/cleanable/ash{step_x = 5; step_y = -5},/obj/effect/decal/cleanable/ash{step_x = 8; step_y = 11},/obj/effect/decal/cleanable/ash{step_x = -6; step_y = 7},/obj/effect/decal/cleanable/ash{step_x = -6; step_y = -8},/obj/effect/decal/cleanable/ash{step_x = -11; step_y = -3},/obj/effect/decal/cleanable/ash{step_x = 10; step_y = 0},/obj/effect/decal/cleanable/ash{step_x = 8; step_y = 6},/obj/effect/decal/cleanable/ash{step_x = -11; step_y = 14},/obj/effect/decal/cleanable/ash{step_x = -1; step_y = 15},/obj/effect/decal/cleanable/ash{step_x = 21; step_y = 25},/obj/effect/decal/cleanable/ash{step_x = 30; step_y = 9},/obj/effect/decal/cleanable/ash{step_x = 23; step_y = 9},/obj/effect/decal/cleanable/dirt/dust,/obj/effect/decal/cleanable/dirt/dust,/obj/effect/decal/cleanable/dirt/dust,/obj/effect/decal/cleanable/dirt/dust,/turf/open/floor/plating/pavement/sidewalk,/area/template_noop)
"G" = (/obj/effect/decal/cleanable/ash{step_x = -7; step_y = -5},/obj/effect/decal/cleanable/ash{step_x = -11; step_y = 1},/obj/effect/decal/cleanable/ash{step_x = 4; step_y = 2},/obj/effect/decal/cleanable/ash{step_x = 3; step_y = 3},/obj/effect/decal/cleanable/ash{step_x = 12; step_y = 13},/obj/effect/decal/cleanable/dirt/dust,/obj/effect/decal/cleanable/dirt/dust,/obj/effect/decal/cleanable/dirt/dust,/obj/effect/decal/cleanable/dirt/dust,/obj/effect/decal/cleanable/dirt/dust,/turf/open/floor/plating/pavement/sidewalk,/area/template_noop)
"H" = (/obj/effect/decal/cleanable{step_x = 18; step_y = 30},/obj/effect/decal/cleanable/ash{step_x = 1; step_y = 8},/obj/effect/decal/cleanable/ash{step_x = 14; step_y = 23},/obj/effect/decal/cleanable/dirt/dust,/obj/effect/decal/cleanable/dirt/dust,/obj/effect/decal/cleanable/dirt/dust,/obj/effect/decal/cleanable/dirt/dust,/obj/effect/decal/cleanable/dirt/dust,/turf/open/floor/plating/pavement/sidewalk,/area/template_noop)
"I" = (/obj/effect/decal/cleanable/ash{step_x = 4; step_y = 6},/obj/effect/decal/cleanable/dirt/dust,/obj/effect/decal/cleanable/dirt/dust,/obj/effect/decal/cleanable/dirt/dust,/obj/effect/decal/cleanable/dirt/dust,/obj/effect/decal/cleanable/dirt/dust,/turf/open/floor/plating/pavement/sidewalk,/area/template_noop)
"J" = (/obj/effect/decal/cleanable/ash{step_x = 26; step_y = 18},/obj/effect/decal/cleanable/dirt/dust,/obj/effect/decal/cleanable/dirt/dust,/obj/effect/decal/cleanable/dirt/dust,/turf/open/floor/plating/pavement/sidewalk,/area/template_noop)
"K" = (/obj/effect/decal/cleanable/ash{step_x = 11; step_y = 29},/turf/closed/wall/rust,/area/template_noop)
"L" = (/obj/effect/decal/cleanable/ash{step_x = 0; step_y = 28},/turf/closed/wall/rust,/area/template_noop)
"M" = (/obj/effect/decal/cleanable/ash{step_x = 21; step_y = 28},/turf/closed/wall/rust,/area/template_noop)
"N" = (/obj/effect/decal/cleanable/dirt/dust,/obj/machinery/vending/snack,/obj/effect/decal/cleanable/dirt/dust,/obj/effect/decal/cleanable/dirt/dust,/turf/open/floor/plating/pavement/sidewalk,/area/template_noop)
"O" = (/obj/effect/decal/cleanable/dirt/dust,/turf/template_noop,/area/template_noop)

(1,1,1) = {"
aaaaaaaaaaaaaaaaaaaaaaaaaaaaaa
aabbbbaabbbbbbbccccccccccbbbaa
bbbbbbbbbbbbbbbcbbbbbbbbcbbbaa
bccbbbbccccccccccccccccbcaabaa
bcdeekkkkkkkkkkkkkkeejcccccccc
bfghijlmkknkokpeekkkejceveekDc
bqstuwzeBekkkkejjCkkkeeeykkeec
bEFGHIjjjjjjjjJjjjekkkckkkxeec
bccKcccjccLccccccMrrrrckeejjAc
bbbbcAAjeNkkcbbbbbOOOOcccccccc
bbbbcAAeekkkcbbbbbOOOOaaaaaabb
bbbbcAjeekkkcbbbbbaaaaaaaaaaba
bbbbcccecccccbbbbbbaaaaaaaaaaa
"}
