"a" = (/turf/template_noop,/area/template_noop)
"b" = (/turf/open/floor/plating/ashplanet/ash,/area/template_noop)
"c" = (/obj/structure/spawner/skeleton,/turf/open/floor/plating/ashplanet/ash,/area/template_noop)

(1,1,1) = {"
aaaaabaaaaa
abababababa
ababbbabaab
aabbbbbbbbb
babbbbbbbab
abbbbcbbbba
abbbbbbbbba
aabbbbbbbba
aabbbbbbbab
abbabbabbab
babababaaba
aaaabaaabaa
"}
