"a" = (/turf/open/space/basic,/area/space)
"b" = (/turf/closed/wall/mineral/gold,/area/space)
"c" = (/obj/structure/mineral_door/gold,/turf/open/space/basic,/area/space)
"d" = (/turf/open/lava,/area/space)
"e" = (/obj/effect/spawner/trap,/turf/open/space/basic,/area/space)
"f" = (/obj/structure/punji_sticks,/turf/open/space/basic,/area/space)
"g" = (/mob/living/simple_animal/hostile/retaliate/ghost,/turf/open/space/basic,/area/space)
"h" = (/obj/effect/sliding_puzzle{reward_type = "/obj/item/granter/spell/charge"},/turf/open/space/basic,/area/space)
"i" = (/obj/item/kinetic_crusher,/turf/open/space/basic,/area/space)
"j" = (/obj/item/flashlight/lantern,/turf/open/space/basic,/area/space)
"k" = (/obj/item/pickaxe/silver,/turf/open/space/basic,/area/space)
"l" = (/obj/effect/mob_spawn/human/miner/explorer,/turf/open/space/basic,/area/space)
"m" = (/obj/item/necromantic_stone,/turf/open/space/basic,/area/space)
"n" = (/obj/structure/headpike,/turf/open/space/basic,/area/space)

(1,1,1) = {"
aaaaaaaaaaaaaaaaaaaaaaaaaaaaaaaaaaaaaaaa
aaaabbbbbbbbbbbbbbbbbbbbbbbbbbbbbbbbaaaa
aaaabaaaabaaaaaaaaaaaaaaaaaaaaaaaaabaaaa
aaaabaaaabaaaaaaaaaaaaaaaaaaaaaaaaabaaaa
aaaabaijabbbbcbbbbaaaaaaaaaaaaaaaaabaaaa
bbbbbaklabaaaaaaabaaaaaaaaaaaaaaaaabbbbb
baaacaaaabaaaaaaabaaaaaaaaamaaaaaaaaaaab
bababbbbbbaaaaaaabaaaaaaaaaaaaaaaaaaaaab
babaabaaabaaahaaabaaaaaaaaaaaaaaaaaaaaab
babdabababaaaaaaabaaaaaaaaaaaaaaaaaaaaab
babdabababaaaaaaabaaaaaaaaaaaaaaaaaaaaab
babdabjbaajaaaaaabaaaaaaaaaaaaaaaaaaaaab
babdaaabebbbbbbbbbaaaaaaaaaaaaaaaaaaaaab
babbbbbbbbajaaeaacaaaaaaaaaaaaaaaaaaaaab
baaaaaaaacaaaaaaabaaaaabaaaaaaaaaaaaaaab
bbbbbbbbbbaaeaaejbaaaaabaaaaaaaaaaaaaaab
beaeaeaaaneaanbbbbaaaaabaaaaaaaaaaaaaaab
beaaaeaeaaaaaabaaaaaaaabbbbbbbbaaaaaaaab
beaeaaaeaanaanbaaaaaaaaaaaaaaabaaabaaaab
bfaffaaaabbaabbjaaaeaaaaajaaaabaaabaaaab
baaaabeaabaaaaaaabbbbbbaaaaaaaabaabaaaab
bffafbeeabaaaaaaabaaaabaaaaaaaaababaaaab
baaaabaaabaaaabbbbjaajbaaaeaaaaaabbaaaab
bafffbaeabgaeaaaaaaaaaeaaaaabaaaaabaaaab
baaaabaaabaaaaaaaeaaaaaaaaaabbaaaaaaaaab
bffafbbaebaaaabbbbaaaabbbbaababaaaaaaaab
baaaaaaaabaeaaaaabaaaabaaaaabaabaaaaaaab
bfafafeaebaagaajabaeeabaeaaabaaabbbaaaab
baafaaaaebbbbbbaabaaaababbbbbaeaaaaaaaab
bafafaeaabaaaaaaabeaaebaeaaabaabaaaaaaab
bbbbbbeeabaeaaaaabaaaabaaaaabaabaaaaaaab
aaaaabaaabaaabbbbbaaaabbbbbabaebaabbbbbb
aaaaabaeaeaaabaaaaaaaaaaaabaeaabaabaaaaa
aaaaabeaaaaaabaaaaaaaaaaaabaaaabaabaaaaa
aaaaabbbbbbbbbaaaaaaaaaaaabbbbbbbbbaaaaa
"}
