"a" = (/turf/open/space/basic,/area/space)
"b" = (/turf/closed/wall/mineral/gold,/area/space)
"c" = (/obj/structure/mineral_door/gold,/turf/open/space/basic,/area/space)
"d" = (/turf/open/lava,/area/space)
"e" = (/obj/effect/spawner/trap,/turf/open/space/basic,/area/space)
"f" = (/obj/structure/punji_sticks,/turf/open/space/basic,/area/space)
"g" = (/mob/living/simple_animal/hostile/retaliate/ghost,/turf/open/space/basic,/area/space)
"h" = (/obj/effect/sliding_puzzle{reward_type = "/obj/item/granter/spell/charge"},/turf/open/space/basic,/area/space)

(1,1,1) = {"
aaaaaaaaaaaaaaaaaaaaaaaaaaaaaaaaaaaaaaaa
aaaabbbbbbbbbbbbbbbbbbbbbbbbbbbbbbbbaaaa
aaaabaaaabaaaaaaaaaaaaaaaaaaaaaaaaabaaaa
aaaabaaaabaaaaaaaaaaaaaaaaaaaaaaaaabaaaa
aaaabaaaabbbbcbbbbaaaaaaaaaaaaaaaaabaaaa
bbbbbaaaabaaaaaaabaaaaaaaaaaaaaaaaabbbbb
baaacaaaabaaaaaaabaaaaaaaaaaaaaaaaaaaaab
bababbbbbbaaaaaaabaaaaaaaaaaaaaaaaaaaaab
babaabaaabaaahaaabaaaaaaaaaaaaaaaaaaaaab
babdabababaaaaaaabaaaaaaaaaaaaaaaaaaaaab
babdabababaaaaaaabaaaaaaaaaaaaaaaaaaaaab
babdababaaaaaaaaabaaaaaaaaaaaaaaaaaaaaab
babdaaabebbbbbbbbbaaaaaaaaaaaaaaaaaaaaab
babbbbbbbbaaaaaaacaaaaaaaaaaaaaaaaaaaaab
baaaaaaaacaaaaaaabaaaaabaaaaaaaaaaaaaaab
bbbbbbbbbbaaaaaaabaaaaabaaaaaaaaaaaaaaab
beaeaeaaaaaaaabbbbaaaaabaaaaaaaaaaaaaaab
beaaaeaeaaaaaabaaaaaaaabaaaaaaaaaaaaaaab
beaeaaaeaaaaaabaaaaaaaaaaaaaaaaaaaaaaaab
bfaffaaaabbaabbaaaaaaaaaaaaaaaaaaaaaaaab
baaaabeaabaaaaaaabbbbbbaaaaaaaaaaaaaaaab
bffafbeeabaaaaaaabaaaabaaaaaaaaaaaaaaaab
baaaabaaabaaaabbbbaaaabaaaaaaaaaaaaaaaab
bafffbaeabgaeaaaaaaaaaeaaaaaaaaaaaaaaaab
baaaabaaabaaaaaaaeaaaaaaaaaaaaaaaaaaaaab
bffafbbaebaaaabbbbaaaabbbbaaaaaaaaaaaaab
baaaaaaaabaeaaaaabaaaabaaaaaaaaaaaaaaaab
bfafafeaebaagaaaabaaaabaeaaaaaaaaaaaaaab
baafaaaaebbbbbbaabaaaabaaaaaaaaaaaaaaaab
bafafaeaabaaaaaaabaaaabaeaaaaaaaaaaaaaab
bbbbbbeeabaeaaaaabaaaabaaaaaaaaaaaaaaaab
aaaaabaaabaaabbbbbaaaabbbbbaaaaaaabbbbbb
aaaaabaeaeaaabaaaaaaaaaaaabaaaaaaabaaaaa
aaaaabeaaaaaabaaaaaaaaaaaabaaaaaaabaaaaa
aaaaabbbbbbbbbaaaaaaaaaaaabbbbbbbbbaaaaa
"}
