"a" = (/turf/closed/mineral/random/no_caves,/area/surface/outdoors/underground/hole)
"b" = (/turf/open/floor/plating/asteroid,/area/surface/outdoors/underground/hole)
"c" = (/obj/effect/baseturf_helper/asteroid,/turf/open/floor/plating/asteroid,/area/surface/outdoors/underground/hole)
"d" = (/obj/structure/ladder/unbreakable/jacob,/turf/open/floor/plating/asteroid,/area/surface/outdoors/underground/hole)

(1,1,1) = {"
aaaaaaaaaaaaaaaaaaa
aaaaaaaaaaaaaaaaaaa
aaaaaaaaaaaaaaaaaaa
aaaaaabbbbbbbaaaaaa
aaaaabbbbbbbbbbaaaa
aaaabbbbbbbbbbbbaaa
aaabbbbbbbbbbbbbaaa
aaabbbbbbbbbbbbbaaa
aabbbbbbbbbbbbbbbaa
aabbcbbbbdbbbbbbbaa
aabbbbbbbbbbbbbbbaa
aabbbbbbbbbbbbbbaaa
aabbbbbbbbbbbbbbaaa
aaabbbbbbbbbbbbbaaa
aaaabbbbbbbbbbbaaaa
aaaabbbbbbbbbaaaaaa
aaaaaaabbbbaaaaaaaa
aaaaaaaaaaaaaaaaaaa
aaaaaaaaaaaaaaaaaaa
"}
