"a" = (/turf/closed/wall/r_wall,/area/template_noop)
"b" = (/obj/effect/spawner/lootdrop/armory_contraband/cybersun,/turf/open/floor/engine,/area/template_noop)
"c" = (/obj/machinery/door/airlock/vault/derelict,/turf/template_noop,/area/template_noop)
"d" = (/obj/structure/closet/crate/wooden/chest,/turf/open/floor/engine,/area/template_noop)

(1,1,1) = {"
aaaaa
abdba
abbba
abbba
aacaa
"}
