"a" = (/turf/template_noop,/area/template_noop)
"b" = (/turf/open/floor/plasteel/rockvault,/area/template_noop)

(1,1,1) = {"
aaaaaaaaaaaaaaaaaaaaaaaaaaaaaaaaaaaaaaaaaaaaaaaaaaaaaaaaaaaaaaaaa
aaaaaaaaaaaaaaaaaaaaaaaaaaaaaaaaaaaaaaaaaaaaaaaaaaaaaaaaaaaaaaaaa
aaaaaaaaaaaaaaaaaaaaaaaaaaaaaaaaaaaaaaaaaaaaaaaaaaaaaaaaaaaaaaaaa
aaaaaaaaaaaaaaaaaaaaaaaaaaaaaaaaaaaaaaaaaaaaaaaaaaaaaaaaaaaaaaaaa
aaaaaaaaaaaaaaaabbbbbbbbbbbbbaaaabbbbbbbbbbbbaaaaabbbbbbbbbbbaaaa
aaaaaaaaaaaaaaaabbbbbbbbbbbbbaaaabbbbbbbbbbbbbbbbbbbbbbbbbbbbaaaa
aaaaaaaaaaaaaaaabbbbbbbbbbbbbaaaabbbbbbbbbbbbbbbbbbbbbbbbbbbbaaaa
aaaaaaaaaaaaaaaabbbbbbbbbbbbbaaaabbbbbbbbbbbbbbbbbbbbbbbbbbbbaaaa
aaaaaaaaaaaaaaaabbbbbbbbbbbbbaaaabbbbbbbbbbbbaaaaabbbbbbbbbbbaaaa
aaaaaaaaaaaaaaaabbbbbbbbbbbbbaaaabbbbbbbbbbbbaaaaabbbbbbbbbbbaaaa
aaaaaaaaaaaaaaaabbbbbbbbbbbbbaaaabbbbbbbbbbbbaaaaabbbbbbbbbbbaaaa
aaaaaaaaaaaaaaaabbbbbbbbbbbbbaaaabbbbbbbbbbbbaaaaaaaaaaaaaaaaaaaa
aaaaaaaaaaaaaaaabbbbbbbbbbbbbaaaabbbbbbbbbbbbaaaaaaaaaaaaaaaaaaaa
aaaaaaaaaaaaaaaaaaaaaaaabbbaaaaaaaabbbaaaaaaaaaaaaaaaaaaaaaaaaaaa
aaaaaaaaaaaaaaaaaaaaaaaabbbaaaaaaaabbbaaaaaaaaaaaaaaaaabbbbbbbbba
aaaaaaaaaaaaaaaaaaaaaaaabbbaaaaaaaabbbaaaaaaaaaaaaaaaaabbbbbbbbba
aaaaaaaaaaaabbbbbbbbbbbbbbbbbbbbbbbbbbbbbbbbbbbbbbbbbbbbbbbbbbbba
aaaaaaaaaaaabbbbbbbbbbbbbbbbbbbbbbbbbbbbbbbbbbbbbbbbbbbbbbbbbbbba
aaaaaaaaaaaabbbbbbbbbbbbbbbbbbbbbbbbbbbbbbbbbbbbbbbbbbbbbbbbbbbba
aaaaaaaaaaaabbbbbbbbbbbbbbbbbbbbbbbbbbbbbbbbbbbbbbbbbbbbbbbbbbbba
aaaaaaaaaaaabbbbbbbbbbbbbbbbbbbbbbbbbbbbbbbbbbbbbbbbbbbbbbbbbbbba
aabbbbbbaaaabbbbbaaaaaaaaaaaaaaaaaaaaaaaaaaaaabbbbbaaaabbbbbbbbba
abbbbbbbbaaabbbbbabbbbbbbaaaaaaaaaaaaabbbbbbbabbbbbaaaabbbbbbbbba
abbbbbbbbaaabbbbbabbbbbbbaaaaaaaaaaaaabbbbbbbabbbbbaaaaaaabbbaaaa
abbbbbbbbaaabbbbbabbbbbbbaaaaaaaaaaaaabbbbbbbabbbbbaaaaaaabbbaaaa
abbbbabbbaaabbbbbabbbbbbbbbbbbaaabbbbbbbbbbbbabbbbbaaaaaaabbbaaaa
abbbbabbbbbbbbbbbabbbbbbbbbbbbaaabbbbbbbbbbbbabbbbbaaaaaaabbbaaaa
abbbbabbbbbbbbbbbabbbbbbbbbbbbaaabbbbbbbbbbbbabbbbbaaaaaaabbbaaaa
aaaaaabbbbbbbbbbbaaaaaaaaaabbbbbbbbbaaaaaaaaaabbbbbaaaaaaabbbaaaa
abbbbabbbbbbbbbbbaaaaaaaaaabbbbbbbbbaaaaaaaaaabbbbbaaaabbbbbbbbba
abbbbabbbbbbbbbbbaaaaaaaaaabbbbbbbbbaaaaaaaaaabbbbbaaaabbbbbbbbba
abbbbabbbaaabbbbbbbbbbbbbbbbbbbbbbbbbbbbbbbbbbbbbbbaaaabbbbbbbbba
abbbbbbbbaaabbbbbbbbbbbbbbbbbbbbbbbbbbbbbbbbbbbbbbbaaaabbbbbbbbba
abbbbbbbbaaabbbbbbbbbbbbbbbbbbbbbbbbbbbbbbbbbbbbbbbaaaabbbbbbbbba
abbbbbbbbaaabbbbbbbbbbbbbbbbbbbbbbbbbbbbbbbbbbbbbbbaaaabbbbbbbbba
aabbbbbbaaaabbbbbbbbbbbbbbbbbbbbbbbbbbbbbbbbbbbbbbbaaaabbbbbbbbba
aaaaaaaaaaaaaaaaaaaaaaaaaaaaabbbbbaaaaaaaaaaaaaaaaaaaaabbbbbbbbba
aaaaaaaaaaaaaaaaaaaaaaaaaaaaabbbbbaaaaaaaaaaaaaaaaaaaaabbbbbbbbba
aaaaaaaaaaaaaaaaaaaaaaaaaaaaabbbbbaaaaaaaaaaaaaaaaaaaaabbbaaaaaaa
aaaaaaaaaaaaaaaaaaaaaaaaaaaaabbbbbaaaaaaaaaaaaaaaaaaaaabbbaaaaaaa
aaaaaaaaaaaaaaaaaaaaaaaaaaaaabbbbbaaaaaaaaaaaaaaaaaaaaabbbaaaaaaa
aaaaaaaaaaaaaaaaaaaaaaaaaaaaabbbbbaaaaaaaaaaaaaaaaabbbbbbbbbbbbba
aaaaaaaaaaaaaaaaaaaaaaaaaaaaabbbbbaaaaaaaaaaaaaaaaabbbbbbbbbbbbba
aaaaaaaaaaaaaaaaaaaaaaaaaaaabbbbbbbaaaaaaaaaaaaaaaabbbbbbbbbbbbba
aaaaaaaaaaaaaaaaaaaaaaaaaaabbbbbbbbbaaaaaaaaaaaaaaabbbbbbbbbbbbba
aaaaaaaaaaaaaaaaaaaaaaaaaabbbbbbbbbbbaaaaaaaaaaaaaaaaaaaaaaaaaaaa
aaaaaaaaaaaaaaaaaaaaaaaaabbbbbbbbbbbbbaaaaaaaaaaaaaaaaaaaaaaaaaaa
aaaaaaaaaaaaaaaaaaaaaaaaabbbbbbbbbbbbbaaaaaaaaaaaaaaaaaaaaaaaaaaa
aaaaaaaaaaaaaaaaaaaaaaaaabbbbbbbbbbbbbaaaaaaaaaaaaaaaaaaaaaaaaaaa
aaaaaaaaaaaaaaaaaaaaaaaaaaaaaaaaaaaaaaaaaaaaaaaaaaaaaaaaaaaaaaaaa
"}
