"a" = (/turf/template_noop,/area/template_noop)
"b" = (/mob/living/simple_animal/hostile/skeleton,/turf/open/floor/plating/asteroid,/area/template_noop)
"c" = (/turf/open/floor/plating/asteroid,/area/template_noop)
"d" = (/turf/closed/mineral/random,/area/template_noop)
"e" = (/obj/item/flashlight/lantern,/turf/open/floor/plating/asteroid,/area/template_noop)
"f" = (/obj/effect/baseturf_helper/asteroid,/turf/open/floor/plating/asteroid,/area/template_noop)

(1,1,1) = {"
aaaaaaaaaaaaaaaaaaabccccccccccaaaaaaaaaa
aaaaaaaaaaaaaaacccccccccccccbcccccaaaaaa
aaaaaaaaaaaacccccccccddddddccccccccaaaaa
aaaaaaaaaaacccccccdddddddddddccccccaaaaa
aaaaaaaaaaccccccdddddddddddddcccbccaaaaa
aaaaaaaaacccccddddddddddddddccccccaaaaaa
aaaaaaaaaccccddddddddddddccccccccaaaaaaa
aaaaaaaaacccdddddddddcccccccccaaaaaaaaaa
aaaaaaaaacccdddddddccecccbcccaaaaaaaaaaa
aaaaaaaaccccddddddccccccccbccaaaaaaaaaaa
aaaaaaacbccccccccccccccccccaaaaaaaaaaaaa
aaaaaaccccccccbcccccccccaaaaaaaaaaaaaaaa
aaaaaacbccccccccccccccaaaaaaaaaaaaaaaaaa
aaaaacccccdddddccccccaaaaaaaaaaaaaaaaaaa
aaaaccccdddddddddccccaaaaacccccccccaaaaa
aaaaccccdddddddddccecaaccccccccbcccccaaa
aaaaccbddddddddddccccccccccccccccccccaaa
aaaccccdddddddddcccccccccccdddcccccccaaa
aaaccccdddddddddccccccccddddddddceccccaa
aaaccccdddddddddccccccdddddddddddcccccca
aaadccccddddddddcccccdddddddddddddccccca
aaaaccccdddddddccccccdddddddddddddcccbcc
aaaabcccddddddccccbccddddddddddddddccccc
aaaaccccdddccccccccccdddddddddddddddcccc
aaaaacccddcccccccccccdddddddddddddddcccc
aaaaaccccccccccdddccddddddddddddddddccbc
aaaaaacccccccddddccccddddddddddddddddccc
aaaaaacbcccccddddcccccccccdddddddddddccc
aaaaaacccccdddddcfcbcccccccccccdddddcccc
aaaaaaaccccddddcccccccbccccccccdddddcccc
aaaaaaacccddddccccaaccccccccccbcddddcccc
aaaaaaccccdddccccaaaaaaaaaacccccdddccccc
aaaaaacccdddccccaaaaaaaaaaaaccccdddcccca
aaaaaccccddcccccaaaaaaaaaaaaccccdddcbcca
aaaaaccccccbcccaaaaaaaaaaaaaccccddccccca
aaaacccccccccaaaaaaaaaaaaaaaaccccdccccca
aaaaacbccccaaaaaaaaaaaaaaaaaacccccccccaa
aaaaaaccccaaaaaaaaaaaaaaaaaaaaacccccccaa
aaaaaaaaaaaaaaaaaaaaaaaaaaaaaaaacccbccaa
aaaaaaaaaaaaaaaaaaaaaaaaaaaaaaaaaaaaaaaa
"}
