"a" = (/turf/template_noop,/area/template_noop)
"b" = (/mob/living/simple_animal/hostile/skeleton,/turf/open/floor/plating/asteroid,/area/template_noop)
"c" = (/turf/open/floor/plating/asteroid,/area/template_noop)
"d" = (/turf/closed/mineral/random,/area/template_noop)
"e" = (/obj/item/flashlight/lantern,/turf/open/floor/plating/asteroid,/area/template_noop)

(1,1,1) = {"
aaaaaaaaaaaaaaaaaaabcbccccccccaaaaaaaaaa
aaaaaaaaaaaaaaacccccccccccccbcccccaaaaaa
aaaaaaaaaaaaccccccbccddddddccccccccaaaaa
aaaaaaaaaaacccccccdddddddddddccccccaaaaa
aaaaaaaaaaccccccdddddddddddddcccbccaaaaa
aaaaaaaaacccbcddddddddddddddccccccaaaaaa
aaaaaaaaaccccddddddddddddccccccccaaaaaaa
aaaaaaaaacccdddddddddcccccccccaaaaaaaaaa
aaaaaaaaacbcdddddddccecccbcccaaaaaaaaaaa
aaaaaaaaccccddddddccccccbcbccaaaaaaaaaaa
aaaaaaacbccccccccccccbcccccaaaaaaaaaaaaa
aaaaaaccccccccbcccccccccaaaaaaaaaaaaaaaa
aaaaaacbcccccccccccbccaaaaaaaaaaaaaaaaaa
aaaaacccccdddddccccccaaaaaaaaaaaaaaaaaaa
aaaaccccdddddddddccccaaaaacccccccccaaaaa
aaaaccccdddddddddccecaacccccccbbcccccaaa
aaaacbbddddddddddcccccccccbccccccccccaaa
aaaccccdddddddddcccccccbcccdddcccccccaaa
aaaccccdddddddddccbcccccddddddddceccccaa
aaaccccdddddddddccccccdddddddddddcccccca
aaadccccddddddddcccccdddddddddddddcbccca
aaaacccbdddddddccccccdddddddddddddcccbcc
aaaabcbcddddddccccbccddddddddddddddccccc
aaaaccccdddccccccccccdddddddddddddddcccc
aaaaacccddcccccccccccdddddddddddddddcbcc
aaaaaccccccccccdddccddddddddddddddddccbc
aaaaaacccccccddddccccddddddddddddddddccc
aaaaaacbcccccddddcccccccccdddddddddddccc
aaaaaacccccdddddcccbccbccccccccdddddcccc
aaaaaaaccccddddcccccccbccbcccccdddddcccc
aaaaaaacccddddccccaaccccccccbcbcddddcbcc
aaaaaaccccdddccccaaaaaaaaaacccccdddccccc
aaaaaacccdddccccaaaaaaaaaaaaccbcdddcccca
aaaaacbccddcccccaaaaaaaaaaaaccccdddcbcca
aaaaaccccccbcccaaaaaaaaaaaaaccccddccccca
aaaaccbccccccaaaaaaaaaaaaaaaacbccdccccca
aaaaacbcbccaaaaaaaaaaaaaaaaaacccccccbcaa
aaaaaaccccaaaaaaaaaaaaaaaaaaaaacccbcccaa
aaaaaaaaaaaaaaaaaaaaaaaaaaaaaaaacccbccaa
aaaaaaaaaaaaaaaaaaaaaaaaaaaaaaaaaaaaaaaa
"}
