"a" = (/turf/closed/mineral/random,/area/space)
"b" = (/mob/living/simple_animal/hostile/skeleton,/turf/open/floor/plating/asteroid,/area/space)
"c" = (/turf/open/floor/plating/asteroid,/area/space)
"d" = (/obj/item/flashlight/lantern,/turf/open/floor/plating/asteroid,/area/space)

(1,1,1) = {"
aaaaaaaaaaaaaaaaaaabccccccccccaaaaaaaaaa
aaaaaaaaaaaaaaacccccccccccccccccccaaaaaa
aaaaaaaaaaaacccccccccaaaaaaccccccccaaaaa
aaaaaaaaaaacccccccaaaaaaaaaaaccccccaaaaa
aaaaaaaaaaccccccaaaaaaaaaaaaacccbccaaaaa
aaaaaaaaacccccaaaaaaaaaaaaaaccccccaaaaaa
aaaaaaaaaccccaaaaaaaaaaaaccccccccaaaaaaa
aaaaaaaaacccaaaaaaaaaccccccccccaaaaaaaaa
aaaaaaaaccccaaaaaaaccdcccccccaaaaaaaaaaa
aaaaaaaaccccaaaaaacccccccccccaaaaaaaaaaa
aaaaaaacbcccccccccccccccccccaaaaaaaaaaaa
aaaaaaccccccccbcccccccccaaaaaaaaaaaaaaaa
aaaaaaccccccccccccccccaaaaaaaaaaaaaaaaaa
aaaaacccccaaaaaccccccaaaaaaaaaaaaaaaaaaa
aaaaccccaaaaaaaaaccccaaaaacccccccccaaaaa
aaaaccccaaaaaaaaaccdcaaccccccccccccccaaa
aaaacccaaaaaaaaaaccccccccccccccccccccaaa
aaaccccaaaaaaaaacccccccccccaaacccccccaaa
aaaccccaaaaaaaaaccccccccaaaaaaaacdccccaa
aaaccccaaaaaaaaaccccccaaaaaaaaaaacccccca
aaaaccccaaaaaaaacccccaaaaaaaaaaaaaccccca
aaaaccccaaaaaaaccccccaaaaaaaaaaaaacccccc
aaaaccccaaaaaaccccbccaaaaaaaaaaaaaaccccc
aaaaccccaaaccccccccccaaaaaaaaaaaaaaacccc
aaaaacccaacccccccccccaaaaaaaaaaaaaaacccc
aaaaaccccccccccaaaccaaaaaaaaaaaaaaaacccc
aaaaaacccccccaaaaccccaaaaaaaaaaaaaaaaccc
aaaaaacccccccaaaacccccccccaaaaaaaaaaaccc
aaaaaacccccaaaaacccccccccccccccaaaaacccc
aaaaaaaccccaaaaccccccccccccccccaaaaacccc
aaaaaaacccaaaaccccaaccccccccccccaaaacccc
aaaaaaccccaaaccccaaaaaaaaaacccccaaaccccc
aaaaaacccaaaccccaaaaaaaaaaaaccccaaacccca
aaaaaccccaacccccaaaaaaaaaaaaccccaaacccca
aaaaaccccccccccaaaaaaaaaaaaaccccaaccccca
aaaacccccccccaaaaaaaaaaaaaaaaccccaccccca
aaaaaccccccaaaaaaaaaaaaaaaaaacccccccccaa
aaaaaaccccaaaaaaaaaaaaaaaaaaaaccccccccaa
aaaaaaaaaaaaaaaaaaaaaaaaaaaaaaacccccccaa
aaaaaaaaaaaaaaaaaaaaaaaaaaaaaaaaaaaaaaaa
"}
