"a" = (/turf/closed/wall,/area/space)
"b" = (/turf/template_noop,/area/space)
"c" = (/turf/open/floor/plasteel,/area/space)
"d" = (/turf/open/floor/plating/pavement/sidewalk,/area/space)
"e" = (/obj/structure/window/fulltile,/turf/template_noop,/area/space)
"f" = (/turf/open/floor/plating,/area/space)
"g" = (/obj/structure/table,/turf/open/floor/plasteel,/area/space)
"h" = (/turf/open/floor/carpet/blue,/area/space)
"i" = (/obj/structure/rack,/turf/open/floor/carpet/blue,/area/space)
"j" = (/obj/structure/rack,/obj/item/cdcase,/turf/open/floor/carpet/blue,/area/space)
"k" = (/obj/structure/rack,/obj/item/cdcase/weezer,/turf/open/floor/carpet/blue,/area/space)
"l" = (/obj/structure/rack,/obj/item/cd,/turf/open/floor/carpet/blue,/area/space)
"m" = (/obj/structure/chair{dir = 4},/turf/open/floor/plating/pavement/sidewalk,/area/space)
"n" = (/obj/structure/table,/turf/open/floor/plating/pavement/sidewalk,/area/space)
"o" = (/obj/structure/chair{dir = 8},/turf/open/floor/plating/pavement/sidewalk,/area/space)
"p" = (/obj/structure/table,/turf/open/floor/plating,/area/space)
"q" = (/obj/structure/window/fulltile,/turf/open/floor/plating/pavement/sidewalk,/area/space)
"r" = (/obj/item/storage/bag/tray/pan,/turf/open/floor/plating/pavement/sidewalk,/area/space)
"s" = (/obj/structure/reagent_dispensers/cooking_oil,/turf/open/floor/plating,/area/space)
"t" = (/obj/structure/window/fulltile,/turf/open/floor/plasteel,/area/space)
"u" = (/obj/structure/rack,/turf/open/floor/plasteel,/area/space)
"v" = (/obj/structure/toilet,/turf/open/floor/plasteel,/area/space)
"w" = (/obj/structure/table/reinforced,/turf/open/floor/plasteel,/area/space)
"x" = (/obj/structure/mineral_door/plastic,/turf/open/floor/plasteel,/area/space)
"y" = (/obj/structure/sink{dir = 8; pixel_x = 11},/turf/open/floor/plasteel,/area/space)
"z" = (/obj/structure/toilet{dir = 1},/turf/open/floor/plasteel,/area/space)
"A" = (/obj/effect/decal/cleanable/blood/gibs,/obj/effect/decal/cleanable/blood,/obj/structure/toilet{dir = 1},/turf/open/floor/plasteel,/area/space)
"B" = (/obj/structure/table/reinforced,/turf/open/floor/carpet/blue,/area/space)
"C" = (/obj/machinery/paystand,/obj/structure/table,/turf/open/floor/plasteel,/area/space)

(1,1,1) = {"
aaaaaaaaaaaaaaaaaaaaaaaaaaaaaaaaaaaaaaaaaaaaaaaaaaaaaaaaaaaaaaaaaaaaaaaaaaaaaaaaaaaaaaaaa
accccccccccccccccaccccaccccccccccccaccccccccccccccccaccccccccccccccccccccffffffffaffffffa
accccccccccccccccacccccccccccccccccaccccccccccccccccaccccccccccccccccccccffffffffaffffffa
accccccccccccccccaccccaccccccccccccaccccccccccccccccaggggggggggggggggggggafffffffaffffffa
accccccccccccccccaccccaccccccccccccaccccccccccccccccaccccccccccccccccccccaaaafaaaaaafaaaa
accccccccccccccccaccccaccccccccccccaccccccccccccccccaccccccccccccccccccccaffffffffffffffa
accccccccccccccccaaaacaccccccccccccaccccccccccccccccaccccccccccccccccccccaffffffffffffffa
accccccccccccccccaccccaccccccccccccaccccccccccccccccacccccccaaaaaaaaaaaaaaaaaaffffffffffa
accccccccccccccccaccccaccccccccccccaccccccccccccccccacccccccdmnodmnodmnodmnodapfffppfffpa
aaaaaaaaaaaaaaaccaccccaccccccccccccaccccccccccccccccaccccccddddddddddddddddddapfffppfffpa
acccccacccccccaccaccccaccccccccccccaccccccccccccccccacccccdddmnodmnodmnodmnodapfffppfffpa
acccccccccccccaccaccccaccccccccccccaccccccccccccccccaccccddddddddddddddddddddapfffppfffpa
acccccacccccccacaaaaaaaaaaaaccaaaaaaacaaaaaaaaaaaaaaacccdddddmnodmnodmnodmnodapfffppfffpa
acccccacccccccaddddddddddddddddddddddddddddddddddddddddddddddddddddddddddddddapfffppfffpa
aaacaaaaaaaaaaaddddddddddddddddddddddddddddddddddddddddddddddddddddddddddddddapfffppfffpa
acccccccccccccaddddddddddddddddddddddddddddddddddddddddddddddddddddddddddddddapfffppfffpa
acccccccccccccqddddddrdddddddddddddddddddddddddddddddddddddddddddddddddddddddapfffppfffpa
acccccccccccccqddddddddddddddddddddddddddddddddddddddddddddddddddddddddddddddaffffffffffa
acccccccccccccaddddddddddddddddddddddddddddddddddddddddddddddddddddddddddddddaffffffffffa
accccccccccccccddddddddddddddddddddddddddddddddddddddddddddddddddddddddddddddasssfffffffa
accccccccccccccddddddddddtatttttaaaaaaccatttatttatttccctttaaaaaaaddddddddddddaaaaaaaaaaaa
acccccccccccccadddddddddccccccccauuucaccacccuccuaccatctaccacccccadddddddddddabbbbbbbbbbbb
acccccccccccccqddddddddcccccccccaccccaccccccuccuaucccccccuacccccaddddddddddabbbbbbbbbbbbb
acccccccccccccqdddddddtccuuuuuuuaccccaccccccuccuaucccccccuacccccadddddddddabbbbbbbbbbbbbb
acccccccccccccadddddddaccuuuuuuuaacacaaaauccuccuaucccccccuacccccaddddddddabbbbbbbbbbbbbbb
aaaaaaaaaaaaaaadddddddtccccccccccccaccccauccuccuaucccccccuaaacaaadddddddabbbbbbbbbbbbbbbb
avavavavacccccadddddddtcccccccccwccaccccaucccccuaucccccccuacccccadddddddabbbbbbbbbbbbbbbb
axaxaxaxacyaccadddddddtcccccccccwccaccccaucccccuaucccccccuccccccadddddddabbbbbbbbbbbbbbbb
acccccccccyaccadddddddtuuuuuuuuuwccaccccaucccccuaucccccccuacccccadddddddabbbbbbbbbbbbbbbb
acccccccccyaccadddddddaaaaaaaaaaaaaaaaaaaaacccaaaaaaaaaaaaaaaaaaadddddddabbbbbbbbbbbbbbbb
axaxaxaxacyaccadddddddehijkliiihhhahhhhhacccccaccccccccccccccccccdddddddabbbbbbbbbbbbbbbb
azaAazazacyacccdddddddehhhhhhhhhhhahhhhhacccccaccccccccccccccccccdddddddabbbbbbbbbbbbbbbb
aaaaaaaaaaaacccdddddddehiiiiiiihhhahhhhhacccccaccccccccccccccccccdddddddabbbbbbbbbbbbbbbb
avavavavacyacccdddddddahhhhhhhhhhhahhhhhaaaaaaaccccccccccccccccccdddddddabbbbbbbbbbbbbbbb
axaxaxaxacyaccadddddddhhhhhhhhhhhhahhhhhacccccaccccccccccccccccccdddddddabbbbbbbbbbbbbbbb
acccccccccyaccadddddddahhhhhhhhhhhahhhhhacccccaccccccccccccccccccdddddddabbbbbbbbbbbbbbbb
acccccccccyaccadddddddehiiiiiiihhhBhhhhhacccccaccccccccccccccccccdddddddabbbbbbbbbbbbbbbb
axaxaxaxacyaccadddddddehhhhhhhhhhhBhhhhhacccccaccccccccccccccccccdddddddabbbbbbbbbbbbbbbb
azazazazacccccadddddddehiiiiiiihhhBhhhhhacccccaccccccccccccccccccdddddddabbbbbbbbbbbbbbbb
aaaaaaaaaaaaaaadddddddaaaaaaaaaaaaaaaaaaacccccaccccccccccccccccccdddddddabbbbbbbbbbbbbbbb
acccacccccccccadddddddtccccaccuuuuuuuuuuacccccaccccccccccccccccccdddddddabbbbbbbbbbbbbbbb
acccacccccccccadddddddcccccaccccccccccccccccccaccccccccccccccccccdddddddabbbbbbbbbbbbbbbb
acccacccccccccadddddddcccccaccccccccccccaaaaaaaaaaaaaaaaaaaaaaaaadddddddabbbbbbbbbbbbbbbb
acccaccccccccccdddddddtccccaccuccuccuccuaccccccacccccccccccccccccdddddddabbbbbbbbbbbbbbbb
acccaccccccccccdddddddtccgggccuccuccuccuaccccccacccccccccccccccccdddddddabbbbbbbbbbbbbbbb
acccacccccccccadddddddtccCccccuccuccuccuaccccccccccccccccccccccccdddddddabbbbbbbbbbbbbbbb
acccacccccccccadddddddtcccccccuccuccuccuaaaacaaacccccccccccccccccdddddddabbbbbbbbbbbbbbbb
acccacccccccccadddddddtccgggccuccuccuccuaccccccacccccccccccccccccdddddddabbbbbbbbbbbbbbbb
aaaaaaaaaaaaaaadddddddtccCccccuccuccuccuaccccccaaaaaaacccccccccccdddddddabbbbbbbbbbbbbbbb
acccccccccccccadddddddtcccccccuccuccuccuaccccccacccccacccccccccccdddddddabbbbbbbbbbbbbbbb
acccccccccccccadddddddtccgggccuccuccuccuaccccccacccccacccccccccccdddddddabbbbbbbbbbbbbbbb
acccccccccccccadddddddtccCccccccccccccccaccccccacccccacccccccccccdddddddabbbbbbbbbbbbbbbb
acccccccccccccadddddddtcccccccccccccccccaccccccacccccacccccccccccdddddddabbbbbbbbbbbbbbbb
acccccccccccccadddddddtcccccccuuuuuuuuuuaaaaaaaaaacaaaaaaaaaaaaaadddddddabbbbbbbbbbbbbbbb
acccccccccccccadddddddaaaaaaaaaaaaaaaaaaaccccccaccccccccccccccccadddddddabbbbbbbbbbbbbbbb
acccccccccccccadddddddacccccccccccccccccaccccccaccccccccccccccccadddddddabbbbbbbbbbbbbbbb
acccccccccccccadddddddacccccccccccccccccaccccccaccccccccccccccccadddddddabbbbbbbbbbbbbbbb
acccccccccccccadddddddccccccccccccccccccaaaaacaaccccccccccccccccadddddddabbbbbbbbbbbbbbbb
aaaaaaaaaaaaaaadddddddccccccccccccccccccaccccccaccccccccccccccccadddddddabbbbbbbbbbbbbbbb
abbbbbbbbbbbbbadddddddaccccccccccccccccccccccccaccccccccccccccccadddddddabbbbbbbbbbbbbbbb
abbbbbbbbbbbbbadddddddacccccccccccccccccaccccccaccccccccccccccccadddddddabbbbbbbbbbbbbbbb
abbbbbbbbbbbbbadddddddaaacaaacccacccacccaaaaaaaaaaaaaaaaaaaacaaaadddddddabbbbbbbbbbbbbbbb
abbbbbbbbbbbbbadddddddddddddddddddddddddddddddddddddddddddddddddddddddddabbbbbbbbbbbbbbbb
abbbbbbbbbbbbbadddddddddddddddddddddddddddddddddddddddddddddddddddddddddabbbbbbbbbbbbbbbb
abbbbbbbbbbbbbadddddddddddddddddddddddddddddddddddddddddddddddddddddddddabbbbbbbbbbbbbbbb
abbbbbbbbbbbbbadddddddddddddddddddddddddddddddddddddddddddddddddddddddddabbbbbbbbbbbbbbbb
abbbbbbbbbbbbbadddddddddddddddddddddddddddddddddddddddddddddddddddddddddabbbbbbbbbbbbbbbb
abbbbbbbbbbbbbadddddddddddddddddddddddddddddddddddddddddddddddddddddddddabbbbbbbbbbbbbbbb
abbbbbbbbbbbbbadddddddddddddddddddddddddddddddddddddddddddddddddddddddddabbbbbbbbbbbbbbbb
aaaaaaaaaaaaaaaaaaaaaaaaaaaaaaaaaaddddddddddddddddddddaaaaaaaaaaaaaaaaaaabbbbbbbbbbbbbbbb
bbbbbbbbbbbbbbbbbbbbbbbbbbbbbbbbbaddddddddddddddddddddabbbbbbbbbbbbbbbbbbbbbbbbbbbbbbbbbb
bbbbbbbbbbbbbbbbbbbbbbbbbbbbbbbbbaddddddddddddddddddddabbbbbbbbbbbbbbbbbbbbbbbbbbbbbbbbbb
bbbbbbbbbbbbbbbbbbbbbbbbbbbbbbbbbaddddddddddddddddddddabbbbbbbbbbbbbbbbbbbbbbbbbbbbbbbbbb
bbbbbbbbbbbbbbbbbbbbbbbbbbbbbbbbbaddddddddddddddddddddabbbbbbbbbbbbbbbbbbbbbbbbbbbbbbbbbb
bbbbbbbbbbbbbbbbbbbbbbbbbbbbbbbbbaddddddddddddddddddddabbbbbbbbbbbbbbbbbbbbbbbbbbbbbbbbbb
bbbbbbbbbbbbbbbbbbbbbbbbbbbbbbbbbaddddddddddddddddddddabbbbbbbbbbbbbbbbbbbbbbbbbbbbbbbbbb
bbbbbbbbbbbbbbbbbbbbbbbbbbbbbbbbbaddddddddddddddddddddabbbbbbbbbbbbbbbbbbbbbbbbbbbbbbbbbb
bbbbbbbbbbbbbbbbbbbbbbbbbbbbbbbbbaddddddddddddddddddddabbbbbbbbbbbbbbbbbbbbbbbbbbbbbbbbbb
bbbbbbbbbbbbbbbbbbbbbbbbbbbbbbbbbaddddddddddddddddddddabbbbbbbbbbbbbbbbbbbbbbbbbbbbbbbbbb
bbbbbbbbbbbbbbbbbbbbbbbbbbbbbbbbbaaaaaaaaaaaaaaaaaaaaaaabbbbbbbbbbbbbbbbbbbbbbbbbbbbbbbbb
"}
