"a" = (/turf/closed/wall/mineral/wood/nonmetal,/area/space)
"b" = (/obj/structure/barricade/wooden,/turf/open/floor/wood,/area/space)
"c" = (/turf/open/floor/wood,/area/space)
"d" = (/turf/open/floor/plating/asteroid,/area/space)
"e" = (/obj/structure/barricade/wooden,/turf/open/floor/plating/asteroid,/area/space)

(1,1,1) = {"
dddeedbbaa
ddddddcccb
dddddccccb
dddddccccb
dddcccccca
ddcccccccb
acccccccca
accccccccd
accccccddd
aabaaddddd
"}
