"a" = (/turf/closed/wall/r_wall,/area/template_noop)
"b" = (/obj/effect/spawner/lootdrop/armory_contraband/cybersun,/turf/open/floor/engine,/area/template_noop)
"c" = (/obj/machinery/door/airlock/vault/derelict,/turf/template_noop,/area/template_noop)

(1,1,1) = {"
aaaaa
abbba
abbba
abbba
aacaa
"}
